commit,package,additions,deletions,LOC,change
fe4cd58cced0e15f1848afbc2518ab4a66e6867f,org.apache.tika.batch,6638,0,6638,6638
dbc5eb76b7a21587eba83724e36bff1cb29e72c6,org.apache.tika.batch,251,227,6662,24
8054dddc156444a0e67a66fcd2dbc9b4bb5db4b7,org.apache.tika.batch,13,14,6661,-1
4ae33b70378e0ee66b7d9c95d6fd7d51b10cc658,org.apache.tika.batch,28,26,6663,2
6a013f550bf7e8cfbed4652ec3785e1627d0f7ea,org.apache.tika.batch,353,334,6682,19
b45a092e33c720c8d6f086605366b37432990bab,org.apache.tika.batch,121,124,6679,-3
a19c06feb2b3c315f810cdf2238ca159ffbfc820,org.apache.tika.batch,2,0,6681,2
7ada2169584970ab9cc8d032c1571dfae78d4fe6,org.apache.tika.batch,2,4,6679,-2
88f140f5cfd63202a48bab7a43e2c6cae05ea8da,org.apache.tika.batch,450,450,6679,0
cc326059cd05b9df51bbc82fba6528cb09f4395e,org.apache.tika.batch,149,4,6824,145
cc9fbcf8ae86e08879c64a56c0eed78dd3169ec0,org.apache.tika.batch,27,0,6851,27
90a2202b5b4a75e7f673bfb42a912cb97ae6d26e,org.apache.tika.batch,208,19,7040,189
6029c0d5c4e07ff217fcd43a6c1e81170acf603e,org.apache.tika.batch,5,2,7043,3
4dcfb74cf702aa88a94f58ca79ede313dfb45852,org.apache.tika.batch,4,4,7043,0
8045b054b612d9e4f8449e9c2ab1e4dcfd84214a,org.apache.tika.batch,51,8,7086,43
8f598d701b1782ef6708634a994b0a12e55f02c9,org.apache.tika.batch,42,46,7082,-4
24b8c2a918ac599b5aff1265f2e08014de1a2fe0,org.apache.tika.batch,2,20,7064,-18
71d72df9514ec970f6231f77cd978bf7d15720ea,org.apache.tika.batch,709,350,7423,359
91422cb971440950403688f0cadb10e814d39250,org.apache.tika.batch,1,10,7414,-9
bbbfaac1b5bbcb61bcb6015a196a8de04174b627,org.apache.tika.batch,3,4,7413,-1
a960709593b0a88286e3aa3d1e71888f99ce1b85,org.apache.tika.batch,58,30,7441,28
34db93595c71745e3bccdabc39e72181c03abbbd,org.apache.tika.batch,92,32,7501,60
67fac456cb29359b69e2d1a5e0bc22fd51a09eb5,org.apache.tika.batch,2,2,7501,0
172c58443550d256a94994aba24c6600a2397256,org.apache.tika.batch,13,18,7496,-5
da1fe243ace68cc2b5c4bde022113233ad95ea15,org.apache.tika.batch,107,52,7551,55
80b27e6d843d221de87591d34632e546c0d23b1a,org.apache.tika.batch,13,18,7546,-5
e780d56652d48dd0f50b4e62a58153e95f055022,org.apache.tika.batch,107,52,7601,55
1b72a3863b8eeb5f4f5d290e5f02c7d072b1cd9b,org.apache.tika.batch,20,17,7604,3
c3383b005f9879019a9a18e6eae362e3498acf54,org.apache.tika.batch,10,1,7613,9
e8ee4ce7fbdc4fd8d0a496731f2b0a481687b72f,org.apache.tika.batch,131,156,7588,-25
6ff825c684236a6e1c8a4f77cbcd2d7fb953870e,org.apache.tika.batch,9,20,7577,-11
0d8f030f02830a39e004fbfbd6989128ec2047d7,org.apache.tika.batch,140,176,7541,-36
e56e2b2915e8cebcf97c69cdcb3ecff861434f61,org.apache.tika.batch,161,185,7517,-24
5410928d740baf6cdcf6ce225f105482f3a2fc11,org.apache.tika.batch,12,3,7526,9
134cb3812aba88152f665c1d14ff65092f21d051,org.apache.tika.batch,12,3,7535,9
ebb4bc6d7bf82fe618b7a4b5f4e9b4278b96c0d2,org.apache.tika.batch,12,3,7544,9
b618984cc78df5696886404c6579d2bad71e1bb8,org.apache.tika.batch,12,3,7553,9
cf1c283623b4f53c335335148d0270b7c2ce0a28,org.apache.tika.batch,1,1,7553,0
82ac81bf133f507b3c20c6046d338282ba3b6904,org.apache.tika.batch,1,1,7553,0
083f7b860bd0cb8ff5d13120d808e0c77ce05999,org.apache.tika.batch,5,1,7557,4
e41c129dfe7323b6f58aef2a3eed5167cc16b014,org.apache.tika.batch,1,6,7552,-5
26d6e0d4e6822974d3e1f1cba90e0070ab6dfe30,org.apache.tika.batch,3,3,7552,0
7dd38d5500c539328e2b0a083e1998a28e680539,org.apache.tika.batch,3,4,7551,-1
c0c2eafe46224e5c316f2dede395308930a5ec0d,org.apache.tika.batch,4,2,7553,2
384e97156c5c5bf54d54b452c1783b7c4e5df068,org.apache.tika.batch,74,65,7562,9
b5f5403fb150f2a290fe1cfa10a6fe572b1dd50a,org.apache.tika.batch,81,71,7572,10
10a8eec119c7a77be76000b30aaffb96a552cc44,org.apache.tika.batch,8,6,7574,2
e6e3b8817053e981f3843f1d3b7055b4ae30ed73,org.apache.tika.batch,8,6,7576,2
5f05b511d7d1184f6f25a2b644b615c4f21b8e68,org.apache.tika.batch,75,45,7606,30
7707dea4e0445b0e22e06c9d4cbd069bc72212e2,org.apache.tika.batch,49,29,7626,20
c844fc3928516f710a1e62ab99c4eb3f8ab27410,org.apache.tika.batch,198,42,7782,156
e7b481dd763ff4f586a94b981281923e4604010a,org.apache.tika.batch,247,71,7958,176
180aaa213d2dc697f8bad0eafdb9d316ad307218,org.apache.tika.batch,3,2,7959,1
01c53eaa6d709972b03735574aa58dc0abcdc51c,org.apache.tika.batch,1,1,7959,0
5a4a0eecf61d7ced2a708d0184df5179c125dd4b,org.apache.tika.batch,5,8,7956,-3
64302aa88bd8de81771712ccafa778a34cefd7c2,org.apache.tika.batch,18,18,7956,0
30c3d8104a51f015416382995435a4785059f07c,org.apache.tika.batch,67,41,7982,26
dfe737c94bb71fe415fb6fa4fae505a73bd2e654,org.apache.tika.batch,67,41,8008,26
6e2822bed2f17b2b55796a6084c36f3060fae3e6,org.apache.tika.batch,22,7,8023,15
862f51af1d75f45ea25aecefa5aee024afc4358b,org.apache.tika.batch,2,0,8025,2
dad1c722ceb7b8583f878d5e5bba88325f5f3530,org.apache.tika.batch,2,1,8026,1
3bdcd9714b8259c7c8c2ae1d5837148016d5bdaf,org.apache.tika.batch,36,9,8053,27
bf224dc2f09c029df3f93ae0b136eb294e2c233f,org.apache.tika.batch,36,9,8080,27
f9104d17ad0b92b243501fdf0863b4ccdaa5e791,org.apache.tika.batch,8,3,8085,5
e538494a43851af54807e4e55817fe742420adcf,org.apache.tika.batch,1,1,8085,0
7af5657b7054082e40e2ab6c894c5f5357c698b9,org.apache.tika.batch,1,1,8085,0
3bc0835d640c4dc51619b60821f546d3365ecc23,org.apache.tika.batch,1,1,8085,0
ccb4c2f02d4dd11a0fabcb7349e0784d8165dd6e,org.apache.tika.batch,16,20,8081,-4
f29362d91b46864a7f924c60f7cf691ac18f11b2,org.apache.tika.batch,6,8,8079,-2
53fef890942bdf69d455abbbecc17cd22d6621d6,org.apache.tika.batch,1,1,8079,0
44c0c83971ab5503db4e7258e258a0d3a360594a,org.apache.tika.batch,1,1,8079,0
7595d820633d2588234b6650ab36265a4dcdfec0,org.apache.tika.batch,6,8,8077,-2
faad4c316634880df054dc6178e18f172a132d4e,org.apache.tika.batch,4,4,8077,0
37f0559c28dd485557f5d66e9c0fe6cb6123b225,org.apache.tika.batch,4,4,8077,0
d27f148ef720559f17bdd16be456de904159ce7e,org.apache.tika.batch,10,8,8079,2
8dfee9ecff0ad4f01555abdae82d5e5e8e5c8690,org.apache.tika.batch,5,8,8076,-3
49bd7d574143fde300151f70319d9cc25559e66d,org.apache.tika.batch,5,8,8073,-3
6401ca084ac9409bf6b6c94b2fa4ff293e427133,org.apache.tika.batch,2,2,8073,0
3571725a948a4676f1904799209271eeaf18b102,org.apache.tika.batch,1,3,8071,-2
dd85c73094dc87f6f6e208278325be810761f490,org.apache.tika.batch,1,3,8069,-2
326b7d7abda238ccc181fc2acaf2271e08fe9c1b,org.apache.tika.batch,3,1,8071,2
7f65d61b4fe1f4c1d4929bbe1c456c68afd44b6c,org.apache.tika.batch,1,3,8069,-2
a77cf075e846390fc25768b1cc8c59a56c2ab9e3,org.apache.tika.detect,59,0,59,59
7d67ade82b0022851d5f8c6d6811328b200d10f6,org.apache.tika.detect,2,2,59,0
006831e911d0583045379830ffd77ec58ffb351d,org.apache.tika.detect,181,0,240,181
2e25dc0d756327e90cfbfca1b27e440b4a2e8b21,org.apache.tika.detect,1,0,241,1
2a6d72672029eda0fa94547c0febf84b57a6bc6c,org.apache.tika.detect,64,13,292,51
e11ead4e079a326bc22be640894b46cd6131037d,org.apache.tika.detect,2,0,294,2
d806c4d505445bd764541a5061963c5e99088390,org.apache.tika.detect,120,0,414,120
816eb2675a0c9bbdcfcb0bba139cbad0a7a5d35b,org.apache.tika.detect,313,0,727,313
b6bcbd9db2c10ba2358da965a65f91939ec69deb,org.apache.tika.detect,180,0,907,180
59ec6ce2fcb68ec2cefdc0e52edd84196abe77d0,org.apache.tika.detect,27,1,933,26
de1a3536a9a92d9d4af33f89abaefbe3dd85de31,org.apache.tika.detect,6,7,932,-1
32d2989e2fbc64cba3ac4eea29046f9babc1414e,org.apache.tika.detect,22,9,945,13
073a36a4e54d6541923bb47f682088cb9838ae4b,org.apache.tika.detect,56,43,958,13
e167f836e62ef2e0cb0c853ee6a1f1219825c20b,org.apache.tika.detect,49,0,1007,49
368e6fafc5bce2abd9efeba0800d098a876cbcfc,org.apache.tika.detect,67,0,1074,67
fd0470f664576fdfffe2cafd3f90f924021df38b,org.apache.tika.detect,26,16,1084,10
acf76a64d81eb9c901d92fe718c0f0ffb4d14ced,org.apache.tika.detect,13,2,1095,11
d34e55056c344bcc561e4213058f1d4fd8b87139,org.apache.tika.detect,9,1,1103,8
efdda0a5d6219d0a44c71f7d7dd0f05819841186,org.apache.tika.detect,49,73,1079,-24
57cfc63946ebd79a3732d99955915f5e12fa75ea,org.apache.tika.detect,3,5,1077,-2
3ad79a6a21e0039fb451044b2b9e71f83f258311,org.apache.tika.detect,2,3,1076,-1
67748e39dd351d4fe37febbd7ea3eabb244970d2,org.apache.tika.detect,2,1,1077,1
ead95c8f3034db138f567be98da4503814ed0366,org.apache.tika.detect,5,0,1082,5
72cc380f6a6419ef20cd591186650607884e58ec,org.apache.tika.detect,17,3,1096,14
3ca5da94c605fb8f6d0bbc5e6849e07e0adf1c8c,org.apache.tika.detect,308,0,1404,308
5fcd987552677d28721931f4fddc0192db7f2b9c,org.apache.tika.detect,85,11,1478,74
852dbede2c4ea6585e58c28813a839edb580a05a,org.apache.tika.detect,23,1,1500,22
bc5f04ebb0360874f6b854e18ce766612cf3b369,org.apache.tika.detect,1,1,1500,0
6f48f57a6a0f21e6589a1d512a25574425dcc4cb,org.apache.tika.detect,17,0,1517,17
c0527e022cffb1a554d97d3e9a9d2627d3cfdb33,org.apache.tika.detect,30,27,1520,3
98eb0b0ec46c8a826a8a76a52636d8cc617d3201,org.apache.tika.detect,15,3,1532,12
fc3a08613ba6366b568b7384845a4ead8a76b748,org.apache.tika.detect,24,1,1555,23
c1f7fd7e5de2c31eddf9b0df086d214ea9adf08c,org.apache.tika.detect,386,386,1555,0
bc3fd0722e3f07ba18c54af7108f9f82cd9ea0d9,org.apache.tika.detect,657,657,1555,0
4bf74e902340b89da31eb1427b9b0f19647de9e4,org.apache.tika.detect,239,72,1722,167
e33c7d5726f088b50400197377f2d68e86be118c,org.apache.tika.detect,20,2,1740,18
14be8fe03d632529258f8a687f237253e277fd06,org.apache.tika.detect,20,12,1748,8
3620143ac8c694f7bdea31f2e67c26d86a3f18ab,org.apache.tika.detect,1,1,1748,0
29972fd0e4cfcb772ae465b26b50230313f9c8a4,org.apache.tika.detect,4,17,1735,-13
d60651e489947e4a57eac775928e4b82d77fbd6d,org.apache.tika.detect,32,2,1765,30
3dd12110dad0e5a71555d4e4a0e5a6cd609b0fb7,org.apache.tika.detect,1,1,1765,0
eb949a4915e0b2acd93b964aca718dc997dc8425,org.apache.tika.detect,26,0,1791,26
2a9200837e00473a402e3326357c33b814ecec44,org.apache.tika.detect,7,3,1795,4
12622b402e2343b35b7ee3d09bc506660583f985,org.apache.tika.detect,390,471,1714,-81
0fa372711329b8765545b9f28f1112d9e955352e,org.apache.tika.detect,66,0,1780,66
9fbce438928982a43fa2ffac51d8550d39a47bef,org.apache.tika.detect,4,0,1784,4
90b0f8e906a5890b6c41bfc4f7b234cdbe24bcab,org.apache.tika.detect,10,6,1788,4
0a7b8ce9f466dd895316084dcdd1ccc5401629a4,org.apache.tika.detect,6,19,1775,-13
3e0191d232a8574083f3648f2b6b8590ac132c15,org.apache.tika.detect,6,1,1780,5
87fd9affb574d62ed26d669adaa3d7cf37e124fb,org.apache.tika.detect,11,48,1743,-37
ddceb68bdabc6fb732ecf2182dcb589237277a58,org.apache.tika.detect,3,1,1745,2
c3318a107e894b6c38b5ab753ba999583c8a99b2,org.apache.tika.detect,2,2,1745,0
0ac8f50dc27155252cd352b761403b12f8a4030f,org.apache.tika.detect,35,0,1780,35
717b17387f2b8d3fb0decf4a9699f21e7f673fad,org.apache.tika.detect,35,12,1803,23
9dc084c72fb87729f3344109c8a3146cca52dc90,org.apache.tika.detect,6,1,1808,5
c4c8b2247dd90e0f5ed3b9eac6da471e013989a8,org.apache.tika.detect,22,0,1830,22
de3538527dc7658735a7544c9f904007bc180021,org.apache.tika.detect,0,0,1830,0
25f7a4d5dac3b7d4bebaed41ef43bf37d1e86814,org.apache.tika.detect,1,67,1764,-66
e910698ed42888d0c30dde88f2ceac7b2f841b98,org.apache.tika.detect,1,1,1764,0
6d7b5d433152220cff25f88b5a28c00154ac5393,org.apache.tika.detect,145,10,1899,135
17529470f534107f17da6f5632d40c857f8886ee,org.apache.tika.detect,1,0,1900,1
1cbd62ac78ebfa918a96735ec7e3f430692a6a7d,org.apache.tika.detect,7,0,1907,7
78f6eac056f8298cdcb80381a1628023a2392a4d,org.apache.tika.detect,69,34,1942,35
ba101bb023a9553d0b5c22b0b625d0a0f1b8a707,org.apache.tika.detect,35,2,1975,33
2b39c7599a9930f8847f8839e9612ae5cdc56407,org.apache.tika.detect,42,10,2007,32
1b01e4f1d943437f29f414dd75a3fa52a05e8d67,org.apache.tika.detect,9,2,2014,7
4885ea7e2eb8a557879a08be9eae85224b718063,org.apache.tika.detect,6,0,2020,6
96c92f509db1f424147ac0f1b7a5cfcfe6211435,org.apache.tika.detect,1,1,2020,0
e735a659560602a1372c5aa64b3ee2475f0d1a67,org.apache.tika.detect,41,0,2061,41
50437f30e0a6c6969be162dc1e768ab061e67dac,org.apache.tika.detect,1,0,2062,1
853fea00ee10fc660470643162e430a5be555560,org.apache.tika.detect,21,3,2080,18
75d487d306d75995484f1d010ab7e712dd2026eb,org.apache.tika.detect,6,0,2086,6
57a99d012bc43d04ded8e7d88e056680542b405f,org.apache.tika.detect,42,2,2126,40
7c43bff1a585550a2e1854e5de05c37c56ec7cde,org.apache.tika.detect,9,0,2135,9
5498c0eeea7d2a5d6d314bcddc7d307830e97c27,org.apache.tika.detect,2,1,2136,1
a547dde812cce268518796e116f63ef0a3f4c8f3,org.apache.tika.detect,40,0,2176,40
fbd2d6db793746fbb5f605731157b5181dd6ee9d,org.apache.tika.detect,1,1,2176,0
16c92d0345873591dab9f9fad199d83fe11ce7b1,org.apache.tika.detect,40,27,2189,13
d8e91b6beb45376a351305c53698ccca98177462,org.apache.tika.detect,5,0,2194,5
3ffc69f708beda7886fe2ebd51b4b3543851a91e,org.apache.tika.detect,181,19,2356,162
9e38af6975e80ffdc8ca028f0abdd6ed1e4f5fbd,org.apache.tika.detect,4,0,2360,4
929c8972a112ac75e5bec8120f0df5d7e5d5ec60,org.apache.tika.detect,60,1,2419,59
6621297537770ca9149e06ee2977483009f8860f,org.apache.tika.detect,122,0,2541,122
89941a2ba1e4b13c3de9c5cf050e4dbf1edafca3,org.apache.tika.detect,1,1,2541,0
7d89a5e455686a945f2e3302f0d201e5e6c4a985,org.apache.tika.detect,147,26,2662,121
dfcf3d4c7cee2dac641ea5b331965ad03ce37364,org.apache.tika.detect,30,2,2690,28
95b897540065ecb8dc1962cf2383a6a3f355762d,org.apache.tika.detect,6,0,2696,6
7260050594e7a13283d2dbfd1a079149a63d43ac,org.apache.tika.detect,14,7,2703,7
2052fc98acca935fa065ffdca302bc84cfe60ac9,org.apache.tika.detect,2,0,2705,2
76cfbc18533c65ecfc07b3233015b9886938bf08,org.apache.tika.detect,5,0,2710,5
22fc879bf987c2ab1fa24d68c10a97cb4797614e,org.apache.tika.detect,65,3,2772,62
2a36fcd63ddd3234b7f34e6814972bb62aeb4bc9,org.apache.tika.detect,58,16,2814,42
359aae57ce045de191a14bb369e7980154deffc6,org.apache.tika.detect,1,0,2815,1
ee8bc664d8848378205646209f10a0fb5a001555,org.apache.tika.detect,22,3,2834,19
9eaa4fc560810dc689055d0fc80693bc7a3f1dda,org.apache.tika.detect,2,3,2833,-1
6cc0e11b91ee5ebe97ea91fc50a76074f45829c2,org.apache.tika.detect,9,3,2839,6
50dcb7b3e93ad26b006de513dcd51fef4a7d67f4,org.apache.tika.detect,1,1,2839,0
892f3a8b1e44efdf86ec9aed0887de7afcbf01ea,org.apache.tika.detect,8,11,2836,-3
fe76f5716d09471a8751ad5bb88a7650f73d235b,org.apache.tika.detect,9,1,2844,8
44032dea24f5f1d23dd0a53b1a297369e4fe7890,org.apache.tika.detect,12,0,2856,12
3f6d06f8b46a14eba6011d781e5e5a86b5043896,org.apache.tika.detect,6,9,2853,-3
257a53b8a83caa5de9067b9c3b3b5e2b356f674d,org.apache.tika.detect,1,0,2854,1
281fedfc86acbb5e01015f1462a27a86a65403f0,org.apache.tika.detect,93,0,2947,93
39352e988f3a1bf5d294a839330f8dd2400d873d,org.apache.tika.detect,709,0,3656,709
cd91ee48fbac5dc7945cad04d5d7c396cbdcba8a,org.apache.tika.detect,9,5,3660,4
3784cac1f447ccf71c645361335407cf8b65b6e7,org.apache.tika.detect,51,52,3659,-1
c3d82a84eb5a5105672b3b237c139c1921020944,org.apache.tika.detect,6,37,3628,-31
62428f2d6530e9d72f772bd163c010a3bd4f4eb9,org.apache.tika.detect,37,5,3660,32
f4bdbbe73dad9e7b979c4bdabc6312bb2ca0d57c,org.apache.tika.detect,15,20,3655,-5
f71910e2e00b55fbfd339e6d682521f64de0c696,org.apache.tika.detect,20,21,3654,-1
8938fdfa93f8c0647e547e8a04a187fbb5a32603,org.apache.tika.detect,28,57,3625,-29
e7a3a49561cc1f9ffa4cd34307005f559dcefe19,org.apache.tika.detect,2,0,3627,2
e07bbf8edb5403aa8ee77be45ce1bc31f2c162b5,org.apache.tika.detect,32,52,3607,-20
44462fb2314e798969878ee91ea2b620965fa20f,org.apache.tika.detect,265,266,3606,-1
9e9ea27a665506579b329c66bff9934de19e6128,org.apache.tika.detect,9,1,3614,8
d447193f29531df3022f5137b8f0ec1c73e58cc8,org.apache.tika.detect,101,0,3715,101
eede044eab86b5a380ddd8a585e6dda563dc42d3,org.apache.tika.detect,3,2,3716,1
a91d083602f716e3fb92b9b791fd602deceef513,org.apache.tika.detect,5,4,3717,1
114b6044a74fe463b90712345ea8e3b2cb085b62,org.apache.tika.detect,2,2,3717,0
75fc12bb83df079f7fa236e0b674274a8c36abde,org.apache.tika.detect,8,2,3723,6
c1a3ce0ee108d865beaa765bd169fa9b463135a2,org.apache.tika.detect,109,0,3832,109
b2821d921ac4cfd3be468e8bea9123f5cb627cbf,org.apache.tika.detect,20,5,3847,15
de6dbd0a7fbb2e24c357020e51f28d21c2ad2ebf,org.apache.tika.detect,20,5,3862,15
e780d56652d48dd0f50b4e62a58153e95f055022,org.apache.tika.detect,129,5,3986,124
d6981ad81334eb20174004d7c0d96acd9f1d2f12,org.apache.tika.detect,11,0,3997,11
fe559b80bcad1f107904ca7a89724a26ea2921a1,org.apache.tika.detect,140,5,4132,135
bf12e5ac576c5766999083b4e6fe6070ccf9daef,org.apache.tika.detect,7,9,4130,-2
84a37209e1c6e27491c9e828799919bc32f8787e,org.apache.tika.detect,2,2,4130,0
836e2d9040bacd7a8ffe88095187aa28ff26c6ba,org.apache.tika.detect,19,3,4146,16
6d022be03b5423f6c036e1aa45e4ce02a9678462,org.apache.tika.detect,217,8,4355,209
e7a0c3eece98ac81b3813aeb429b24f16090201c,org.apache.tika.detect,9,3,4361,6
75eea6e5502f4f5a2edf5ab459b4c369d33f66e5,org.apache.tika.detect,10,0,4371,10
a194bc4ba2b771807e93e664245f24e3573a15df,org.apache.tika.detect,5,0,4376,5
d77fb59a54b40d1f850a89053bebd87409b2b05c,org.apache.tika.detect,5,0,4381,5
70d2455c4ff7c54afe6762d5b50653b8de06f2b2,org.apache.tika.detect,15,0,4396,15
e56e2b2915e8cebcf97c69cdcb3ecff861434f61,org.apache.tika.detect,390,11,4775,379
6b174ecbb70d1236bdb9886f86bf94f51d3dd881,org.apache.tika.detect,15,0,4790,15
83f1afae3db65af966b13e6cc6dae3872aef630f,org.apache.tika.detect,48,0,4838,48
7dd38d5500c539328e2b0a083e1998a28e680539,org.apache.tika.detect,48,0,4886,48
0d92bc862c3c344d65d3f6c260b0f5ea4c389fc0,org.apache.tika.detect,2,0,4888,2
b5f5403fb150f2a290fe1cfa10a6fe572b1dd50a,org.apache.tika.detect,2,0,4890,2
10a8eec119c7a77be76000b30aaffb96a552cc44,org.apache.tika.detect,9,6,4893,3
e6e3b8817053e981f3843f1d3b7055b4ae30ed73,org.apache.tika.detect,9,6,4896,3
4b38d6228f4ba5ee912735dc692275499bbf45f6,org.apache.tika.detect,45,16,4925,29
64bb30844e0caafff1c9ebac7c8b0c5b512ea81e,org.apache.tika.detect,9,1,4933,8
e24e6afb1c2a37be266839767115ad6adc5f8dcf,org.apache.tika.detect,4,6,4931,-2
7a69da1ba6b07fed00dbbf0ce7b822c3fb77a381,org.apache.tika.detect,15,0,4946,15
b10c24dc8283401c9ef93b3a8535880ebfb30e6f,org.apache.tika.detect,2,1,4947,1
e7b481dd763ff4f586a94b981281923e4604010a,org.apache.tika.detect,17,1,4963,16
01c53eaa6d709972b03735574aa58dc0abcdc51c,org.apache.tika.detect,3,4,4962,-1
d6eb8b9fbf6eb6f1198c5b6f54931b065519bf79,org.apache.tika.detect,18,2,4978,16
02560a13408de42c960bab2807d8baec8ba2ab08,org.apache.tika.detect,18,2,4994,16
c797a83db923ceb01c9703f4a8a935c231eb9bd7,org.apache.tika.detect,5,9,4990,-4
6745e8db32390ea94ca14f11ef02aa00f1ffc37e,org.apache.tika.detect,5,9,4986,-4
b1adfb9c67e6321264f4451af822f999081fc326,org.apache.tika.detect,19,1,5004,18
7175b9027fb4c8566822c57b428363bc35893d74,org.apache.tika.detect,9,2,5011,7
c89fc0c95937b71e9c1a1b5905f34e0dc1cb650f,org.apache.tika.detect,46,3,5054,43
9cb838227a020744e27c0b5adbbd1652c8f2dda1,org.apache.tika.detect,9,0,5063,9
b329820804bb74cc290337041eee595395e77435,org.apache.tika.detect,3,1,5065,2
f52838fd0c88c4c843c2cd778fd32ea7184bc902,org.apache.tika.detect,7,0,5072,7
62fe4ada48f961ec49a41f6b67f28a64681c9b93,org.apache.tika.detect,3,3,5072,0
f9104d17ad0b92b243501fdf0863b4ccdaa5e791,org.apache.tika.detect,3290,574,7788,2716
e538494a43851af54807e4e55817fe742420adcf,org.apache.tika.detect,1,1,7788,0
7af5657b7054082e40e2ab6c894c5f5357c698b9,org.apache.tika.detect,1,1,7788,0
d4a39b4873d939553e0742487b8c84f072497c1f,org.apache.tika.detect,48,0,7836,48
0c4c24dafe28c5cebb03f3946a3cfaf3c2cd04f4,org.apache.tika.detect,2,5,7833,-3
f41fdd0d15e196ef04b4e833cb0a498d51bd9bfd,org.apache.tika.detect,2,10,7825,-8
ee8caf69456bd52d278283792dc1b9c56477c243,org.apache.tika.detect,310,0,8135,310
f0df1f50a801a1816e1cc2fc1cf7a686a86f4dbb,org.apache.tika.detect,2,2,8135,0
faad4c316634880df054dc6178e18f172a132d4e,org.apache.tika.detect,1,2,8134,-1
37f0559c28dd485557f5d66e9c0fe6cb6123b225,org.apache.tika.detect,1,2,8133,-1
d27f148ef720559f17bdd16be456de904159ce7e,org.apache.tika.detect,13,1,8145,12
8dfee9ecff0ad4f01555abdae82d5e5e8e5c8690,org.apache.tika.detect,3,6,8142,-3
49bd7d574143fde300151f70319d9cc25559e66d,org.apache.tika.detect,3,6,8139,-3
673e665312c79534b32b05122e31a61dd2c5e7d4,org.apache.tika.detect,2,22,8119,-20
372ccd23e6399de9b5d9d93906645e1e4349ec99,org.apache.tika.detect,1,3,8117,-2
6401ca084ac9409bf6b6c94b2fa4ff293e427133,org.apache.tika.detect,10,11,8116,-1
9ec102102119e6d398c53652e1a28c2c61600f5d,org.apache.tika.detect,4,4,8116,0
8dbb5736fa92b323e270e2075b42dce458a3abd6,org.apache.tika.detect,0,1238,6878,-1238
a43784b19f6b0955478dded71521b0491d21c90b,org.apache.tika.detect,1238,0,8116,1238
8b82b4c942c82f9cc2eb393e669227606b5f15fc,org.apache.tika.detect,83,4,8195,79
23eb15c03247372db6734f4da82ecc66b7b48072,org.apache.tika.example,126,0,126,126
979c7d8b7db9513f55d3cdcea6e50c8642964c73,org.apache.tika.example,64,0,190,64
e5717ac261edb99e535bd89fb416c81f51e3f68b,org.apache.tika.example,78,0,268,78
b15e67f1febd7cd8755ab0eea2127d112413e0f3,org.apache.tika.example,130,0,398,130
25dc052fec6520a4b15b502c6c23c7f337cd0518,org.apache.tika.example,79,3,474,76
295658d8e49f0ea04003c2c3d3069aa969141e53,org.apache.tika.example,52,2,524,50
85b96e00105772d34e76897ed5c5437945429ea3,org.apache.tika.example,295,0,819,295
d26f2a3aeee312941c259b2779fce8bced5b4f3e,org.apache.tika.example,0,1,818,-1
fdd49692c545393e2f7c4d008d93c45e044be443,org.apache.tika.example,96,0,914,96
a8fee2dabb161b2a1161cd5569d0453a02ef501f,org.apache.tika.example,34,0,948,34
5976d3198e886ccc125cd1f73d33600d9eeb4829,org.apache.tika.example,341,12,1277,329
b871795c3d28d713290138a8c565fc203d0881f2,org.apache.tika.example,89,2,1364,87
892f3a8b1e44efdf86ec9aed0887de7afcbf01ea,org.apache.tika.example,21,18,1367,3
6778d5d07bfcf5d1e0f2ed4a84d9097010f9a2b0,org.apache.tika.example,191,8,1550,183
f54cb9e354b71e720602acfa0b4da8f100b400c2,org.apache.tika.example,2369,0,3919,2369
88f140f5cfd63202a48bab7a43e2c6cae05ea8da,org.apache.tika.example,1520,1520,3919,0
2764fb8606964c3350c781ecf5df4042706b4099,org.apache.tika.example,1,1,3919,0
165eebcb5bcc2f6b5768bcdec5ce6496c3ca5093,org.apache.tika.example,194,0,4113,194
4dcfb74cf702aa88a94f58ca79ede313dfb45852,org.apache.tika.example,20,20,4113,0
532de24487a647ba831b73a1a53e230e4052bd55,org.apache.tika.example,29,31,4111,-2
650d01c48d420df99b5d516dcf9643a8632a32fc,org.apache.tika.example,40,12,4139,28
d5796b9151def0e762eac7f66f9243f1a27958c6,org.apache.tika.example,16,11,4144,5
f67c93c819533917e47a488c64b5865a3979f8c4,org.apache.tika.example,1,1,4144,0
7f5ef182628f22885863a33f5372c514c82e8f11,org.apache.tika.example,6,10,4140,-4
4e7851d2767ccba289a95c0f981e19b0edc68671,org.apache.tika.example,7,6,4141,1
7695a018507eb6ba7e9fd66d22b9f95ff7bb664d,org.apache.tika.example,30,22,4149,8
8938fdfa93f8c0647e547e8a04a187fbb5a32603,org.apache.tika.example,29,100,4078,-71
03af7fb6a1d1477464024497748ec48cf0872382,org.apache.tika.example,1470,1481,4067,-11
dba2033b703b4fd4eee0f6831c29b4323b1180dd,org.apache.tika.example,36,21,4082,15
b3665cde6c397ce3968374607bc07a54bacf4b51,org.apache.tika.example,91,0,4173,91
c31fe5533598aa155b521395d17b2932d6d4fe4e,org.apache.tika.example,2,1,4174,1
ffb46d6a5851201f278dd69df6b8f78c7cbd5225,org.apache.tika.example,97,49,4222,48
d6d180c5d94d80722e239341e4eb8398a32817cd,org.apache.tika.example,75,44,4253,31
83a3bb9b14e7b075a52174dee139278dd6052d7c,org.apache.tika.example,45,37,4261,8
f3cd6ad3ff45e19cd2f0919d686f0a283893fc94,org.apache.tika.example,20,0,4281,20
3a7a94ca5040eabd90f6060effc517126def3fc1,org.apache.tika.example,33,28,4286,5
f9113be57db9607c0e3710b8560989e0f8f8efef,org.apache.tika.example,10,12,4284,-2
3aa1dca4eef13de99b83989010fe02bfd391b378,org.apache.tika.example,10,229,4065,-219
9cdfc4ae23fe9be3b62c827d3771f7bd713fcc63,org.apache.tika.example,32,29,4068,3
71f8423b0403955265a0726ff3173cc5708518c4,org.apache.tika.example,9,5,4072,4
da1fe243ace68cc2b5c4bde022113233ad95ea15,org.apache.tika.example,9,5,4076,4
20c1cfe8f024bf51a5aeb37656e4566420377868,org.apache.tika.example,32,29,4079,3
e780d56652d48dd0f50b4e62a58153e95f055022,org.apache.tika.example,41,34,4086,7
7b4f6fa6c76430dbc0eeb4e6654b59e3afc38185,org.apache.tika.example,6,3,4089,3
e8ee4ce7fbdc4fd8d0a496731f2b0a481687b72f,org.apache.tika.example,6,7,4088,-1
0d8f030f02830a39e004fbfbd6989128ec2047d7,org.apache.tika.example,6,7,4087,-1
e56e2b2915e8cebcf97c69cdcb3ecff861434f61,org.apache.tika.example,77,39,4125,38
e76302196ebcafb7b51fce37fbe8256e6c0fbc51,org.apache.tika.example,109,0,4234,109
7b869c0c1b132feb691dca645fe9bc689bf320e2,org.apache.tika.example,1,1,4234,0
b5f5403fb150f2a290fe1cfa10a6fe572b1dd50a,org.apache.tika.example,109,0,4343,109
10a8eec119c7a77be76000b30aaffb96a552cc44,org.apache.tika.example,27,20,4350,7
e6e3b8817053e981f3843f1d3b7055b4ae30ed73,org.apache.tika.example,27,20,4357,7
5f05b511d7d1184f6f25a2b644b615c4f21b8e68,org.apache.tika.example,6,4,4359,2
c0fb57d9d20e8eb7cb77bce8742e4566a18f5db8,org.apache.tika.example,10,2,4367,8
40028f3c4934b86ddf48a536da2e8191d20a4695,org.apache.tika.example,27,239,4155,-212
5a4a0eecf61d7ced2a708d0184df5179c125dd4b,org.apache.tika.example,2,2,4155,0
0d6f140a18f049689bd6a5d69398c33e3af82291,org.apache.tika.example,0,10,4145,-10
e83b999e0ab77971489356cca745746dd60aa55d,org.apache.tika.example,1,1,4145,0
8bc50ecf2f06e65eb86637b813e199b6ba59fcc4,org.apache.tika.example,93,0,4238,93
346d12fd719689b555df3a27441e5dcb0e0b6fcd,org.apache.tika.example,1,1,4238,0
f9104d17ad0b92b243501fdf0863b4ccdaa5e791,org.apache.tika.example,214,1,4451,213
236125ab1ec492f393fcbf26af0df30c8ae7619a,org.apache.tika.example,3,3,4451,0
53fef890942bdf69d455abbbecc17cd22d6621d6,org.apache.tika.example,1,5,4447,-4
44c0c83971ab5503db4e7258e258a0d3a360594a,org.apache.tika.example,1,5,4443,-4
9ec102102119e6d398c53652e1a28c2c61600f5d,org.apache.tika.example,2,2,4443,0
219338f0925ef55a4748906e14a757a05b94ce35,org.apache.tika.example,5,4,4444,1
6b51782400d51402646aaa226df246d98e06a65d,org.apache.tika.fork,46,7,39,39
42eecdb41065d65a2b7ffcf6a760e62331c86962,org.apache.tika.fork,56,2,93,54
26800770bde7df358548d8d2e52b7bd0d073e881,org.apache.tika.fork,18,0,111,18
1d0ef6b779d1ff1b0cabf0ffd9e453e5cf2619bf,org.apache.tika.fork,164,80,195,84
ab0921a36ba8226d3393b1712b9c28d4af9e9e0e,org.apache.tika.fork,695,129,761,566
1812a8612fff219adc7c2d0daada8aa652104024,org.apache.tika.fork,134,165,730,-31
bb31716e5eaf69fe8f25beb3f870aceaa27b0328,org.apache.tika.fork,16,18,728,-2
ba8a9691beb2721f64f767ededeae14b467589f9,org.apache.tika.fork,287,105,910,182
bdc9e61e5991f574e3e028b65ab36fb1da4ed63c,org.apache.tika.fork,11,7,914,4
663b274999afde94e851477d1ebebfdefaa19188,org.apache.tika.fork,4,2,916,2
aec08ff85b1c2550664f81c549c65bb36978237d,org.apache.tika.fork,2,2,916,0
3b3845a0cc3c1a6e53d05c0e3ba2f77f2c33d1e0,org.apache.tika.fork,177,29,1064,148
739124326ad8fa6e26af71ef0a25855265328ae1,org.apache.tika.fork,51,0,1115,51
4a9b1f499739475d5e222e76b8cfaf6eefc7ceab,org.apache.tika.fork,97,32,1180,65
1466606243db1323d0c307df9f2f52de2272a70b,org.apache.tika.fork,25,15,1190,10
f4098f1015ebf887fab336d58ce44224f3ed815c,org.apache.tika.fork,7,4,1193,3
b1e9764ea707bc5b0ccc01d24af836a6f6e5ddba,org.apache.tika.fork,23,1,1215,22
3b61cea5aba160f9289db7d913aec2c00c3b7a6e,org.apache.tika.fork,4,14,1205,-10
5f8737a853d31b82951fadfc7e9ca0c255ff7286,org.apache.tika.fork,92,8,1289,84
15229b624eb50b170d4d93ac1a2ff5918563b7a1,org.apache.tika.fork,1,1,1289,0
f1824961509076594945e0bf50be3d384315edee,org.apache.tika.fork,23,4,1308,19
9f57e910dd236d78b6b045d0d16c5eede91c18eb,org.apache.tika.fork,27,10,1325,17
5943753aaa51c6810d980222af71bf22943ac267,org.apache.tika.fork,2,2,1325,0
c4c8b2247dd90e0f5ed3b9eac6da471e013989a8,org.apache.tika.fork,22,0,1347,22
de3538527dc7658735a7544c9f904007bc180021,org.apache.tika.fork,0,0,1347,0
e910698ed42888d0c30dde88f2ceac7b2f841b98,org.apache.tika.fork,1,1,1347,0
50d6e5858d1557c00a42726cbe59cce3453db245,org.apache.tika.fork,0,2,1345,-2
486d767688ce4c93c9e90ede0b27459cebfa5233,org.apache.tika.fork,36,11,1370,25
dd8480f92b6a7750cb65ce2eb95c9d2fe8b9b988,org.apache.tika.fork,11,0,1381,11
915be4f4fb999a79ea1f3f90b3a2637ea086ae26,org.apache.tika.fork,1,1,1381,0
a90b827bcbed21bb8a149cebdfdd483b3a20d7fe,org.apache.tika.fork,14,1,1394,13
bc075703823e7250a7ad7db93ef58712133920f2,org.apache.tika.fork,18,4,1408,14
833b5e1985f3bb37ee76c85ceddf400b916e3a3b,org.apache.tika.fork,18,0,1426,18
6aba74b05069cc97dfe2df0a194f14ed38a224ba,org.apache.tika.fork,51,2,1475,49
2a36fcd63ddd3234b7f34e6814972bb62aeb4bc9,org.apache.tika.fork,8,3,1480,5
892f3a8b1e44efdf86ec9aed0887de7afcbf01ea,org.apache.tika.fork,1,1,1480,0
6ce4a166486eea12e9987318da24f82aa4a072b6,org.apache.tika.fork,10,9,1481,1
4c1834e4f911f927c35e50547e07ec997993063e,org.apache.tika.fork,40,4,1517,36
f4bdbbe73dad9e7b979c4bdabc6312bb2ca0d57c,org.apache.tika.fork,3,1,1519,2
be5f57dba75055f047284c6136136a600c0bb99c,org.apache.tika.fork,1,2,1518,-1
8938fdfa93f8c0647e547e8a04a187fbb5a32603,org.apache.tika.fork,4,9,1513,-5
61d8ec7534e91bdc994456e1883a5d07abf2037c,org.apache.tika.fork,8,2,1519,6
da1fe243ace68cc2b5c4bde022113233ad95ea15,org.apache.tika.fork,8,2,1525,6
e780d56652d48dd0f50b4e62a58153e95f055022,org.apache.tika.fork,8,2,1531,6
e8bf985040e8b4fe6975468a6b912edd2d3e03d5,org.apache.tika.fork,71,7,1595,64
2e325cb7103f3e7090433264a52f9787200c526e,org.apache.tika.fork,1,1,1595,0
6ff825c684236a6e1c8a4f77cbcd2d7fb953870e,org.apache.tika.fork,7,11,1591,-4
0d8f030f02830a39e004fbfbd6989128ec2047d7,org.apache.tika.fork,7,11,1587,-4
e56e2b2915e8cebcf97c69cdcb3ecff861434f61,org.apache.tika.fork,78,18,1647,60
6a398bd3f6245543091fd7c0e9e4facb34a26882,org.apache.tika.fork,49,1,1695,48
7f6072ca26dccf1d791c426d4c32068535ddae8a,org.apache.tika.fork,49,1,1743,48
ac2c024cee1e8475c056196aae0526120f99a85b,org.apache.tika.fork,49,1,1791,48
bcf09e04d7b232a3d5ac56bd858045e63e41205d,org.apache.tika.fork,254,7,2038,247
87861ae059e7705a8bb9f0692fdf08a8cfd35eeb,org.apache.tika.fork,0,7,2031,-7
e2156ce44ebf1eb49efc608e12dbec905112f39f,org.apache.tika.fork,310,90,2251,220
56ff337b65a5ee66c582ad0e877c6bc583bc3adf,org.apache.tika.fork,2,1,2252,1
0e8f44459fbbed991171e9eafb3395df6060fb7a,org.apache.tika.fork,444,3,2693,441
5ae7cc5d59006e15baa3347954e0545468c0dc94,org.apache.tika.fork,405,80,3018,325
cb1bbc052188bf5e45e5dc17570180df1fe27df9,org.apache.tika.fork,770,5,3783,765
929dcd75b8480a2a2d19a1801a88973b5e9358ac,org.apache.tika.fork,186,133,3836,53
7a69da1ba6b07fed00dbbf0ce7b822c3fb77a381,org.apache.tika.fork,41,3,3874,38
e7b481dd763ff4f586a94b981281923e4604010a,org.apache.tika.fork,1373,108,5139,1265
69555a98e56f4fef62abb91bee48bad27c58a6ce,org.apache.tika.fork,6,30,5115,-24
734358f9870c87dd1739f4e995d0d71765965542,org.apache.tika.fork,32,0,5147,32
5a4a0eecf61d7ced2a708d0184df5179c125dd4b,org.apache.tika.fork,3,3,5147,0
303ccd41d1411b45024248ab5b89978b93bd0cbc,org.apache.tika.fork,2,1,5148,1
c723878ff15fc3b75f1a57fd1a91cf1d9f2577d3,org.apache.tika.fork,6,30,5124,-24
71e59d51c1bf3e4c278ef84c924e70671b49d6be,org.apache.tika.fork,3,1,5126,2
7beae2f510d124adcb60178320317c5d161380d0,org.apache.tika.fork,2,1,5127,1
b83dc002c771b2da50ef66afc22ffced2e54a487,org.apache.tika.fork,2,1,5128,1
231a7e28d6f73db89747b2dcc597efe1add93bbb,org.apache.tika.fork,21,42,5107,-21
c797a83db923ceb01c9703f4a8a935c231eb9bd7,org.apache.tika.fork,2,0,5109,2
f9cccabcb2d2580739039fbef60f06da97668b13,org.apache.tika.fork,1,3,5107,-2
6745e8db32390ea94ca14f11ef02aa00f1ffc37e,org.apache.tika.fork,24,45,5086,-21
377e40b03a5ea762c0f898611e64c70779ba3f16,org.apache.tika.fork,4,1,5089,3
faad4c316634880df054dc6178e18f172a132d4e,org.apache.tika.fork,7,7,5089,0
37f0559c28dd485557f5d66e9c0fe6cb6123b225,org.apache.tika.fork,7,7,5089,0
6401ca084ac9409bf6b6c94b2fa4ff293e427133,org.apache.tika.fork,4,3,5090,1
6b3fb1fa644a93e25f640d08593c849fe24a7784,org.apache.tika.fork,20,30,5080,-10
9ec102102119e6d398c53652e1a28c2c61600f5d,org.apache.tika.fork,2,2,5080,0
d8b0d1fe33942ef49dd34aa58c14b73e27daeadd,org.apache.tika.fork,42,11,5111,31
3571725a948a4676f1904799209271eeaf18b102,org.apache.tika.fork,2,4,5109,-2
dd85c73094dc87f6f6e208278325be810761f490,org.apache.tika.fork,2,4,5107,-2
326b7d7abda238ccc181fc2acaf2271e08fe9c1b,org.apache.tika.fork,4,2,5109,2
7f65d61b4fe1f4c1d4929bbe1c456c68afd44b6c,org.apache.tika.fork,2,4,5107,-2
77428b0f44a61f2f92d9c03fba46b32f01d16d1c,org.apache.tika.metadata,1142,0,1142,1142
21cf8befdbc2f5617da560451cb37f7db65bdc3b,org.apache.tika.metadata,1,1,1142,0
376241396ff4f055188039211af70d9f76c1d4f1,org.apache.tika.metadata,1,1,1142,0
64c1e0e7648f424272c47866ccf28bf6eb11d761,org.apache.tika.metadata,33,0,1175,33
32fda63e7bfb1722a3e35d717f68e3242a259c47,org.apache.tika.metadata,7,17,1165,-10
9ffdd5470b4b66c62b21dac13cb278acf2cad48b,org.apache.tika.metadata,3,0,1168,3
a8d1e675a2c18e67b534df31823214d8c917c07c,org.apache.tika.metadata,27,3,1192,24
579bee49c75df6f44d862418df4b5a58b84361e7,org.apache.tika.metadata,404,404,1192,0
c1fec08438a738fb71a28f7b1675e6d5ffae38cb,org.apache.tika.metadata,16,0,1208,16
2a15448e24d2568629eebed80d6aa35a58350382,org.apache.tika.metadata,1,1,1208,0
8a80ee560caeff41560e9dad911a07a62340a368,org.apache.tika.metadata,24,0,1232,24
1588c38e20098a1f728ebd160d240fd1c032c701,org.apache.tika.metadata,11,5,1238,6
fd4a584811f027ba94961126e5832c86759b2267,org.apache.tika.metadata,0,413,825,-413
290bbf80a2f5ca1245bf63f4cb5e0ca92d6c0beb,org.apache.tika.metadata,369,374,820,-5
9544c3a37ee7b679203b382ad469301d41f45436,org.apache.tika.metadata,1,0,821,1
96a15bcc17e2e7db9267bc98a8c449fdf15fa74c,org.apache.tika.metadata,150,0,971,150
443734225ebc709ea3ada622c3ab4a1ac1ff7b6f,org.apache.tika.metadata,5,40,936,-35
0fa888e8d681eaea34de59d67bf4a15472bc859a,org.apache.tika.metadata,533,0,1469,533
3ad79a6a21e0039fb451044b2b9e71f83f258311,org.apache.tika.metadata,22,24,1467,-2
14a229e5814b0148ba0b8d08f0cc71708a861c88,org.apache.tika.metadata,57,1,1523,56
bdf52f7e25cd6615f83bf97db5b981b462adc1c6,org.apache.tika.metadata,3,1,1525,2
571fc144efbc2c86722d64205e91a698905cf9e4,org.apache.tika.metadata,2,25,1502,-23
2b73f6b5b24de8d48def498e46f47ef47a24a440,org.apache.tika.metadata,99,5,1596,94
ed8497d10df01374ddc63ec6cc988c191a881b95,org.apache.tika.metadata,33,1,1628,32
c02b1529c8011a41892975f2bc0f3cace4a11016,org.apache.tika.metadata,1,1,1628,0
9677c502210500e82c72e965502011b9b9a4314e,org.apache.tika.metadata,49,1,1676,48
4658fd738e12bb380b888af906a077da7af1e32d,org.apache.tika.metadata,203,5,1874,198
18f82c74cc8944e6fefb2c88c2bc4d6652500ae6,org.apache.tika.metadata,9,4,1879,5
11bbc01edef720419f3b68e0487ef057cf13a387,org.apache.tika.metadata,5,2,1882,3
ad2259667f97bfb76344e778ee1faf5f208b98d8,org.apache.tika.metadata,59,4,1937,55
458753cfdc2d8f9941ea84a94267b84a323f117f,org.apache.tika.metadata,36,0,1973,36
d32c1d879287b4b9ed81f1cd3b6b52025683f5f1,org.apache.tika.metadata,67,40,2000,27
bc3fd0722e3f07ba18c54af7108f9f82cd9ea0d9,org.apache.tika.metadata,628,628,2000,0
9a2bef7e4d893d7bbde4a267bf3eca6da40ecab2,org.apache.tika.metadata,19,2,2017,17
729bca59b0b81ddcb33054938037a31495bb4edd,org.apache.tika.metadata,95,0,2112,95
806ccd1b7fda712753f855d344b20b4edad24ffe,org.apache.tika.metadata,6,2,2116,4
3dd12110dad0e5a71555d4e4a0e5a6cd609b0fb7,org.apache.tika.metadata,2,3,2115,-1
ab0921a36ba8226d3393b1712b9c28d4af9e9e0e,org.apache.tika.metadata,6,1,2120,5
164302f56b53a1a8f4169a88d30980a8c2897f47,org.apache.tika.metadata,23,13,2130,10
5716665ac46861acb3b14fd56ed8b91d6ddc91f8,org.apache.tika.metadata,7,4,2133,3
8f4b2aed6e404ccac23dac357c799766aa0e793c,org.apache.tika.metadata,8,0,2141,8
1835ad392b2ed8ce0673483833fb28f3f8bdc855,org.apache.tika.metadata,7,0,2148,7
c4c8b2247dd90e0f5ed3b9eac6da471e013989a8,org.apache.tika.metadata,1,0,2149,1
c3f99103fd06292556f9eb0034365f0389205434,org.apache.tika.metadata,2,2,2149,0
5cc8b40243eee50c5364c8f350d1a873cfab8180,org.apache.tika.metadata,41,1,2189,40
25f7a4d5dac3b7d4bebaed41ef43bf37d1e86814,org.apache.tika.metadata,0,92,2097,-92
e910698ed42888d0c30dde88f2ceac7b2f841b98,org.apache.tika.metadata,1,1,2097,0
83eb5b81bca849bf512b84425cd6900c9921b251,org.apache.tika.metadata,10,0,2107,10
f6adfbda369a376d4d03c1c76d14f4736ef6e28c,org.apache.tika.metadata,7,6,2108,1
92f444695e242cb358a6fb52a70210bdcccc2d66,org.apache.tika.metadata,4,0,2112,4
85ae815a0f9a15ffd0a3f3870768630e53e5dd1b,org.apache.tika.metadata,38,10,2140,28
b754b456c3871c453466ff06f60eedf433547eaa,org.apache.tika.metadata,8,4,2144,4
34c029356e5548badbe4e36006036d1c6a0086af,org.apache.tika.metadata,1289,1,3432,1288
7901a55eb6421f6b505f45a649ef41e717db6f5b,org.apache.tika.metadata,16,12,3436,4
6454566da5e6c3ae9fe989145277d3b657f8de65,org.apache.tika.metadata,49,0,3485,49
929f7535e99bac0a604206212253a60a1fdd816f,org.apache.tika.metadata,34,12,3507,22
385c9930d65b4263c1bf26781e38a80195c9a1df,org.apache.tika.metadata,60,21,3546,39
c0d60f016e6dcc03cd1a2b2f460e4c2f61375df8,org.apache.tika.metadata,3,3,3546,0
9e79399d2129cc9ccffaf4cc1834fac742238f05,org.apache.tika.metadata,2,3,3545,-1
49229f793f29af5736e8d8ea964066b0abfc07dc,org.apache.tika.metadata,109,8,3646,101
5796aa68af70085f82216721b529c0bd850f1932,org.apache.tika.metadata,132,0,3778,132
08ef9c198b06fd1c1f4722c53a09945e6377c532,org.apache.tika.metadata,55,29,3804,26
7488dcce89571d9aa81b3ea0fd95bd6f67290c60,org.apache.tika.metadata,11,1,3814,10
ffe9d51a4c966599f2215c6f000030a017b1d35d,org.apache.tika.metadata,75,4,3885,71
ce9ffb3ff03d8a6eb1a0bf16e04d35372a3ba626,org.apache.tika.metadata,121,1,4005,120
a8755b0c33d216be5b64cfd039d0f9dac1f1406e,org.apache.tika.metadata,34,6,4033,28
d22c2ea763889d96c831fdeb0fc55b82b2e7adf4,org.apache.tika.metadata,10,10,4033,0
e2c5e08c3228ce6584467ef272a0f95d8d47a0a5,org.apache.tika.metadata,16,16,4033,0
9b94789f2e9d759d4f6523b3cccd8370831e2469,org.apache.tika.metadata,38,16,4055,22
34dff7b56672b54b19de4ea6e28ad3f95db6d034,org.apache.tika.metadata,58,45,4068,13
70c85b4ab78486b2e2781fe6bd196a053e48149e,org.apache.tika.metadata,1,1,4068,0
a63b29900a9bc4543c5d5c0eb31c2735ebd65e25,org.apache.tika.metadata,1400,1259,4209,141
a0e2a5e1fda9e321ea725dabf2c6219af9a0d6ec,org.apache.tika.metadata,13,2,4220,11
923ef5d6b2101a7500955b9709967c7277ff5674,org.apache.tika.metadata,5,4,4221,1
32033ded8671f9a3d5fd638c652de44c60f3a659,org.apache.tika.metadata,3,3,4221,0
328b935c08b61bf785ec99952c687f04f7cf989f,org.apache.tika.metadata,159,25,4355,134
1d1f29260677d955e66c4dbd6f1120426b421a94,org.apache.tika.metadata,222,7,4570,215
19a8688603dcf50d396c5619685ba75b83107e86,org.apache.tika.metadata,29,38,4561,-9
aa6c45eb3cae0ff0b74c67ba3273d579bde2f56f,org.apache.tika.metadata,29,0,4590,29
a63b9b8a80d52c172d074ae6a7569ac0f5f42b5b,org.apache.tika.metadata,22,20,4592,2
07a1590839bff6f16ac19b031a26e128141e19a2,org.apache.tika.metadata,157,83,4666,74
efdb4679cb28841da7ba9d8e755596602b630893,org.apache.tika.metadata,2,1,4667,1
c36e5a0461b66a7941156dd9ee502c73aa0ee28c,org.apache.tika.metadata,3,2,4668,1
9e21496385fa21e15fbe1f9d2d7160678151fa7c,org.apache.tika.metadata,2,0,4670,2
02e550a358860c7b387599da14b5d92f44a3164d,org.apache.tika.metadata,16,9,4677,7
00522e3cb4b2fa1f2202d56779106f3979cc4225,org.apache.tika.metadata,8,7,4678,1
5a82c4f241b659a9a155df0ed60570e8743029dc,org.apache.tika.metadata,32,17,4693,15
ec32a29d3109df74e56b7878809aa0c5be862666,org.apache.tika.metadata,51,27,4717,24
dfee81089d1492039ab698528212e1cef4108ea2,org.apache.tika.metadata,4,41,4680,-37
2a36fcd63ddd3234b7f34e6814972bb62aeb4bc9,org.apache.tika.metadata,22,17,4685,5
55310ec7f4c8f2bfe6ff29485dfee156e6c9de84,org.apache.tika.metadata,46,0,4731,46
0e7ea0a025b9d32dd2f41bdd25cb005999d4dfeb,org.apache.tika.metadata,27,0,4758,27
08a402913f47d405dd01747452833a771f5accf7,org.apache.tika.metadata,6,6,4758,0
4fa1d2a8c863e79810fc21961e04dcfa75450f93,org.apache.tika.metadata,371,0,5129,371
15bc1b3a1c5e79c007754760eba5748e99b01fc8,org.apache.tika.metadata,30,1,5158,29
204532630e37f76817e8677c58301d22ed576fae,org.apache.tika.metadata,15,0,5173,15
7e6448348853234fe76c732ffeccb76200fe464c,org.apache.tika.metadata,4,2,5175,2
d42e013ff5a31488218b3bd82ebfc7e796a0e852,org.apache.tika.metadata,329,16,5488,313
eb7e3481c0db1069a30e73cfe598cc46ee80560e,org.apache.tika.metadata,1,25,5464,-24
45da28cc03c9ab70273523b945cac3e0f81f7c8d,org.apache.tika.metadata,44,0,5508,44
669565c6e8e90ba439056c5c269dd1a8c6b76369,org.apache.tika.metadata,2,2,5508,0
bb9380c0e07084a65773ef12f014ec1b9ad5fbc6,org.apache.tika.metadata,13,0,5521,13
a4be4be51f22d813cfbb6e249017c83d87346f65,org.apache.tika.metadata,3,3,5521,0
1f32c70e2166cca831a9f52a5362583dd11e3cf6,org.apache.tika.metadata,8,0,5529,8
e66ec97291cff4f14926b6e11b3b79a099cc00cf,org.apache.tika.metadata,25,0,5554,25
d1e8d7176952d7e82e2d72ae08b2ee40df17902e,org.apache.tika.metadata,71,0,5625,71
6194e6854392740a157cce3bb252af10244af8af,org.apache.tika.metadata,17,6,5636,11
43086f4d2c69d69b10b52507be21c33a3397569b,org.apache.tika.metadata,17,17,5636,0
88f140f5cfd63202a48bab7a43e2c6cae05ea8da,org.apache.tika.metadata,123,123,5636,0
4dcfb74cf702aa88a94f58ca79ede313dfb45852,org.apache.tika.metadata,6,6,5636,0
5f3acd22272dcaf8b946feecaf0e1bbebb6489fb,org.apache.tika.metadata,1,1,5636,0
8d8823ad9e8281cf79c492d714ae2a815644f763,org.apache.tika.metadata,4,4,5636,0
559557aa311c6dd81f26d8142a6df6f6fc55513f,org.apache.tika.metadata,2,0,5638,2
f054bcd1a0a57a730ebc53e7a2cfd4215a7526fb,org.apache.tika.metadata,2,0,5640,2
c5d4ec6c50824a9a40fdd2b492bf7557d8d693f3,org.apache.tika.metadata,44,0,5684,44
e032ac61996be58cba306a69165b3986e7b4256a,org.apache.tika.metadata,9,0,5693,9
da1fe243ace68cc2b5c4bde022113233ad95ea15,org.apache.tika.metadata,9,0,5702,9
80b27e6d843d221de87591d34632e546c0d23b1a,org.apache.tika.metadata,9,0,5711,9
e780d56652d48dd0f50b4e62a58153e95f055022,org.apache.tika.metadata,9,0,5720,9
b6d55ae345db933d69cc9a7d290e3f8ca567b5a9,org.apache.tika.metadata,7,0,5727,7
fe559b80bcad1f107904ca7a89724a26ea2921a1,org.apache.tika.metadata,7,0,5734,7
2ae7206d9c99fb553314cff21bb155d4e6f06d12,org.apache.tika.metadata,11,3,5742,8
ce07d8a10499fae015f07ca4fd4daf3473ca5193,org.apache.tika.metadata,67,0,5809,67
8e819c3caf3ff3b0492f600b4193d1b3ee74f51b,org.apache.tika.metadata,6,0,5815,6
7fbf0f304d8e20f7e26baadee1f85974b03dee8e,org.apache.tika.metadata,6,0,5821,6
4dd6fd11035c09070689471975cc661aafa77333,org.apache.tika.metadata,2,2,5821,0
0e0f30d9bb7352bf08c884f8646619ca215a6907,org.apache.tika.metadata,6,0,5827,6
aa448a3b7e61f9a46efd1bf3f2ac72e6a3852d8f,org.apache.tika.metadata,114,0,5941,114
66f6310eec8e8aade078f0ca32a07399008ef1b1,org.apache.tika.metadata,60,44,5957,16
8eb7d352f6b7a488bfdca172a0707cb514157a34,org.apache.tika.metadata,9,0,5966,9
c3383b005f9879019a9a18e6eae362e3498acf54,org.apache.tika.metadata,8,0,5974,8
745f13cbd0dd2143d3a95e414f399bd73b0e47ab,org.apache.tika.metadata,57,2,6029,55
b2f3eafc49221cd099f0ad9126cf90ad5535bdaf,org.apache.tika.metadata,50,29,6050,21
e56e2b2915e8cebcf97c69cdcb3ecff861434f61,org.apache.tika.metadata,364,47,6367,317
132d3e7ff0387234c65cfc2983dd2b6ba59ff38b,org.apache.tika.metadata,29,0,6396,29
134cb3812aba88152f665c1d14ff65092f21d051,org.apache.tika.metadata,29,0,6425,29
ebb4bc6d7bf82fe618b7a4b5f4e9b4278b96c0d2,org.apache.tika.metadata,29,0,6454,29
b618984cc78df5696886404c6579d2bad71e1bb8,org.apache.tika.metadata,29,0,6483,29
83f1afae3db65af966b13e6cc6dae3872aef630f,org.apache.tika.metadata,3,0,6486,3
8000cfec02a0c872241a9bfe90c21675b9118054,org.apache.tika.metadata,3,0,6489,3
7dd38d5500c539328e2b0a083e1998a28e680539,org.apache.tika.metadata,6,0,6495,6
33da38ebb209250680aee3ab8565c89846f3a865,org.apache.tika.metadata,4,0,6499,4
766cdac5735565ba898932c4f8696dc8a678e74b,org.apache.tika.metadata,4,0,6503,4
b1d80bd7a649e90b225b2769c8affc4809a9cb9b,org.apache.tika.metadata,62,2,6563,60
2966cab3d8e4c975ba3b8b04f71d0254eeaf2f8c,org.apache.tika.metadata,1,2,6562,-1
369a04ee2be4b28c2bed1f1119e8cb5805dbd9c8,org.apache.tika.metadata,20,1,6581,19
b5f5403fb150f2a290fe1cfa10a6fe572b1dd50a,org.apache.tika.metadata,87,2,6666,85
a01163de9784cff77733262dad46140e83eb6e11,org.apache.tika.metadata,4,0,6670,4
10a8eec119c7a77be76000b30aaffb96a552cc44,org.apache.tika.metadata,275,502,6443,-227
e6e3b8817053e981f3843f1d3b7055b4ae30ed73,org.apache.tika.metadata,275,502,6216,-227
79f313d85ee558a2ba2e61477ec669ab0281dcb6,org.apache.tika.metadata,3,2,6217,1
5f05b511d7d1184f6f25a2b644b615c4f21b8e68,org.apache.tika.metadata,1,1,6217,0
c844fc3928516f710a1e62ab99c4eb3f8ab27410,org.apache.tika.metadata,126,0,6343,126
e7b481dd763ff4f586a94b981281923e4604010a,org.apache.tika.metadata,126,0,6469,126
5a4a0eecf61d7ced2a708d0184df5179c125dd4b,org.apache.tika.metadata,2,2,6469,0
927c224cde7a7358325c349a3c439766e8ad2988,org.apache.tika.metadata,3,3,6469,0
64302aa88bd8de81771712ccafa778a34cefd7c2,org.apache.tika.metadata,1,1,6469,0
f3099c81e57b5b7f297519a7586b9eb20d89b688,org.apache.tika.metadata,44,0,6513,44
06e734b3cfb192b96581338281c0373ef385d3cf,org.apache.tika.metadata,3,0,6516,3
9a8ef5e7844df2569494b27f51e28047a5596018,org.apache.tika.metadata,1,1,6516,0
ebbd895749337f5bfaa4a653d245ba9356f3207c,org.apache.tika.metadata,5,3,6518,2
7866ce3cc182a02872f504640db22af4fcb3691a,org.apache.tika.metadata,15,0,6533,15
90b63b5f13509a8653c0efc9a69fab4b8cd7295f,org.apache.tika.metadata,28,0,6561,28
45e60a2a8285f49bd9d9f3bdde172b23d0f067a0,org.apache.tika.metadata,2,0,6563,2
c61d0d397aca1ce7c70403b7178d7e64b1f4cc7b,org.apache.tika.metadata,6,3,6566,3
ab8a9ed830ec710a32e4ffdf4989aea3aaea92ef,org.apache.tika.metadata,2,2,6566,0
73eacc2d9bf77d962245b0832ba5d4fe0045ee56,org.apache.tika.metadata,12,0,6578,12
5b27a993aca864e53093ab1bad9fa38dad6448cb,org.apache.tika.metadata,6,0,6584,6
4a4a53e15ed5bae19780d70bda30c58f3878aecd,org.apache.tika.metadata,15,2,6597,13
bb4458e417116cfc1b7cba70783c5a97c9ec3681,org.apache.tika.metadata,14,1,6610,13
f4626a60be540fc0038858d6226c54912c41d5f9,org.apache.tika.metadata,7,5,6612,2
3bdcd9714b8259c7c8c2ae1d5837148016d5bdaf,org.apache.tika.metadata,545,0,7157,545
eb6e07eee192ba961272e4a58eb3bb40bb2371c8,org.apache.tika.metadata,13,18,7152,-5
bf224dc2f09c029df3f93ae0b136eb294e2c233f,org.apache.tika.metadata,540,0,7692,540
d704ea19dcea3d5fab98ac82f027150df790ab0c,org.apache.tika.metadata,1,1,7692,0
f9104d17ad0b92b243501fdf0863b4ccdaa5e791,org.apache.tika.metadata,91,0,7783,91
f29362d91b46864a7f924c60f7cf691ac18f11b2,org.apache.tika.metadata,2,3,7782,-1
2504756b68223b429d481877f4977fc995f24724,org.apache.tika.metadata,2,0,7784,2
7595d820633d2588234b6650ab36265a4dcdfec0,org.apache.tika.metadata,2,3,7783,-1
372ccd23e6399de9b5d9d93906645e1e4349ec99,org.apache.tika.metadata,2,5,7780,-3
9ec102102119e6d398c53652e1a28c2c61600f5d,org.apache.tika.metadata,17,20,7777,-3
376241396ff4f055188039211af70d9f76c1d4f1,org.apache.tika.mime,2340,0,2340,2340
773fbd2a881bc8d81da0a7387fecb86cfb8f64b0,org.apache.tika.mime,16,4,2352,12
32fda63e7bfb1722a3e35d717f68e3242a259c47,org.apache.tika.mime,13,18,2347,-5
83cb301f046cf5621e6e71bcd907fef52c491078,org.apache.tika.mime,8,36,2319,-28
54aa413c1fc4b02b1bcd90228e10bb2e91b30876,org.apache.tika.mime,72,60,2331,12
9fce256813d12e7aeef73bfc6ed3896ad414dc24,org.apache.tika.mime,104,182,2253,-78
b12c01d9b56053554cec501aab0530f7f4352daf,org.apache.tika.mime,53,1,2305,52
2b09facfdc45660389072848fbe2190ed64d1a23,org.apache.tika.mime,15,15,2305,0
91f76e672c7abf4c5d0644c2545f2f767e74674f,org.apache.tika.mime,82,2,2385,80
a7d091baff278e65851ef2affcb3e34d509bb241,org.apache.tika.mime,21,1,2405,20
076d9ef2c5fbe274c4cfa0918f4de4ed92fc88f1,org.apache.tika.mime,3,1,2407,2
9db6b38ae203a0099239ee56ebf07dd81a0871a8,org.apache.tika.mime,47,18,2436,29
001e1f7ea84eeb74022f0339e0c1a3dac8263973,org.apache.tika.mime,46,14,2468,32
5087833918ccb065d8f20743a3ef8d18164ab3ee,org.apache.tika.mime,19,123,2364,-104
2291cab550a7e38671d3f56168dec462021df4f0,org.apache.tika.mime,220,265,2319,-45
b1bcf42b9f21924419d6936ed555ba25e7080bd3,org.apache.tika.mime,30,77,2272,-47
05b7bb7e19b9c3ca05077abecbf7b7a1d447cdca,org.apache.tika.mime,11,21,2262,-10
4b126e887da913b559591eed21bebea8d48d2ae9,org.apache.tika.mime,319,388,2193,-69
3be8f6ce5db19e18f1e81ecbef06f81e0c054a16,org.apache.tika.mime,171,115,2249,56
a01dcbe6552ab1a184544097575aa583ecbbe8cb,org.apache.tika.mime,118,161,2206,-43
fa6bb7e3c92145d29cd97820718ece69fd6ffd62,org.apache.tika.mime,214,11,2409,203
80866ff406ba6dd79c94def3703b18dfaf8128a6,org.apache.tika.mime,3,7,2405,-4
4228d3779dedf42aa3574688cfd68a1d4c5e6e51,org.apache.tika.mime,4,1,2408,3
ddfe1a576cbdbc1176e7fef2606233e0a5b18c5a,org.apache.tika.mime,3,3,2408,0
a5c897e47dddce52877955549517948051126e10,org.apache.tika.mime,350,0,2758,350
c22581fb98ef95a52d360b9ac84fde547e9883c2,org.apache.tika.mime,3,0,2761,3
ca427a103afb541408ebfced5d6e95000dbd626b,org.apache.tika.mime,19,18,2762,1
3079789724edf724c492c3497630c3cbd5533ef5,org.apache.tika.mime,422,422,2762,0
8757a3561c632770595199a5930e02177bd172c1,org.apache.tika.mime,120,41,2841,79
d806c4d505445bd764541a5061963c5e99088390,org.apache.tika.mime,13,15,2839,-2
8b7a1d436b9fe8682b6f93872f7b8ff943b30c4a,org.apache.tika.mime,55,1,2893,54
7789252dcac009d0d0000ecde339bbda318acadf,org.apache.tika.mime,10,8,2895,2
16669e3404af089f19ea3c7227523efa67f84410,org.apache.tika.mime,15,14,2896,1
f807af0ee947affd34d84b334bbdc32c11576b2e,org.apache.tika.mime,11,2,2905,9
741c575948bba334b546f0cae324de23dc2c4aed,org.apache.tika.mime,26,19,2912,7
820841c347f686317217f79ea040cb329730c680,org.apache.tika.mime,24,0,2936,24
de1c077b8bd44808de203ed90ca572fe904d3a00,org.apache.tika.mime,10,0,2946,10
b8a131fa0ee7ee02dfe2df20efe5d2e741e5c0c8,org.apache.tika.mime,7,0,2953,7
16f436c96c9d2517c0fe2c025aaa13e6cdfd2c93,org.apache.tika.mime,9,0,2962,9
418284d1f54cfd621ed8b86b7aec3bb2adbf7af0,org.apache.tika.mime,17,0,2979,17
d966d3531faee373ed15f9768052fdf19c7150b9,org.apache.tika.mime,36,0,3015,36
a93976f529de57b2457b9daffaeaf4fd21bb4ba7,org.apache.tika.mime,13,0,3028,13
411c8806daf4812fd19709162a17f7b2a7b1ecd6,org.apache.tika.mime,5,0,3033,5
442972752663e2c3ed855e757feae8183e3644c1,org.apache.tika.mime,9,0,3042,9
d3a32863c56f6e7080bc62797b9a46a23d1e84b0,org.apache.tika.mime,7,0,3049,7
8dbb649b95194c9d5b55cbac8b52b6cc4208506a,org.apache.tika.mime,6,0,3055,6
0fa61dcd25ed972580a3dd8d25b84f7a17273147,org.apache.tika.mime,15,0,3070,15
2a77cf379166e9c2e5144d9cafa37a2146563a36,org.apache.tika.mime,3,3,3070,0
cc9a94f7156027930963fae50a773da7e4900c12,org.apache.tika.mime,83,21,3132,62
29c5b5284d40055781b561e9d761a7c82f5209e4,org.apache.tika.mime,91,23,3200,68
c5f0d0919e7fd36a1a773006d38253e4bb308a27,org.apache.tika.mime,0,1,3199,-1
049cace04486c84c25bf6bad37eb1939b7f72150,org.apache.tika.mime,19,26,3192,-7
6be2c4ab2f32e036b7e48539087c07b104ee71ea,org.apache.tika.mime,2,2,3192,0
368e6fafc5bce2abd9efeba0800d098a876cbcfc,org.apache.tika.mime,182,16,3358,166
e5d034df892bf6dceaf94026512ac6472372fde1,org.apache.tika.mime,16,0,3374,16
3a6036e57562d2be738184304376b28f65c5418c,org.apache.tika.mime,24,28,3370,-4
fd0470f664576fdfffe2cafd3f90f924021df38b,org.apache.tika.mime,10,1,3379,9
96742ab2fe31bd8d6031d0730baec6df26929b86,org.apache.tika.mime,82,105,3356,-23
0236e017be19e614f34660b0db892ef00cb1a3c9,org.apache.tika.mime,165,25,3496,140
cccb797d8513bda8e42cd0c99e2fca6ee382888f,org.apache.tika.mime,56,48,3504,8
acf76a64d81eb9c901d92fe718c0f0ffb4d14ced,org.apache.tika.mime,77,12,3569,65
3d8a58aa28f15e17c21158d096e24b1f65e750cf,org.apache.tika.mime,11,0,3580,11
290bbf80a2f5ca1245bf63f4cb5e0ca92d6c0beb,org.apache.tika.mime,43,68,3555,-25
1b6a5639611fcea5e81d6891fced6340832b3680,org.apache.tika.mime,12,8,3559,4
f4f7f72f524747ad0cc0aa03ae6f11bbce695d02,org.apache.tika.mime,2627,0,6186,2627
8f9059718b54d7ea03da65c2e111886fd62b41eb,org.apache.tika.mime,9,12,6183,-3
659945d569e597b825e937e5ffa09e12d4fc925c,org.apache.tika.mime,28,33,6178,-5
2ad8d4026fc3da3a4be1ee76e2a41faa19548076,org.apache.tika.mime,10,16,6172,-6
d77f5cfe93298c24725e0e7ce8390ccf06d7b062,org.apache.tika.mime,0,2,6170,-2
a1d21f441ebebc6a18033d59044b8dfad59ddd9c,org.apache.tika.mime,120,121,6169,-1
439f7ede84210e8af77b85f672fe347308617314,org.apache.tika.mime,242,260,6151,-18
cce94cb6805187964e08f6bab460583d41afd610,org.apache.tika.mime,202,192,6161,10
0cc002f2b04f445ab02bbd9dee308ae7179311df,org.apache.tika.mime,53,73,6141,-20
6661e116b1bf24f21b0b62124e8525365deec658,org.apache.tika.mime,76,97,6120,-21
e99d737bffaf899fa2be9d5f852ec00a62e1835c,org.apache.tika.mime,158,226,6052,-68
2ec2eb1d3d51a0d4e23406b9490dce25c2d72ddc,org.apache.tika.mime,168,234,5986,-66
ead42a4a674931f5e2881973471b05b7e9d6d219,org.apache.tika.mime,117,125,5978,-8
b19fe7e33b39aa0cf9848cb0a37a65a1031ac403,org.apache.tika.mime,149,215,5912,-66
710f9bdeca7839a00bdd6a1660939648496d73e7,org.apache.tika.mime,4,14,5902,-10
7990a84fb3f9d1593c382eeb0b50afc8f3f97eca,org.apache.tika.mime,23,3,5922,20
e59923b20a57bb73ea88b272c963a1db1455144d,org.apache.tika.mime,36,19,5939,17
d7a498fc3a2ac21236290760b719d5a6030ab4e7,org.apache.tika.mime,126,51,6014,75
7b0b425482c0469314d081bb9202d2aeda6ac62d,org.apache.tika.mime,16,0,6030,16
c5038b8fd110a3305645ad9791a6d10315ca577f,org.apache.tika.mime,55,19,6066,36
1e7a8745f159ecdb068b7088b0a435d9f9175854,org.apache.tika.mime,1,0,6067,1
987ec1d66d8f7e0047e4a1ef5399e440a15877a2,org.apache.tika.mime,12,0,6079,12
e7524be4e4af1fb2be08b4ee1dd72c8bdac1793c,org.apache.tika.mime,9,0,6088,9
39469baa4c0a991b171dd71b36f65c205058e462,org.apache.tika.mime,26,10,6104,16
995d275ab2bd7c90b8adfc2f03f1cf97c3a7744a,org.apache.tika.mime,0,1,6103,-1
e5b3736215763861aa219cbaaea16e12b42ffcfb,org.apache.tika.mime,1,1,6103,0
bc54bef34c15ef306395ab6da3ad7271f5d516e1,org.apache.tika.mime,1,1,6103,0
98a96dae4038d6e4f1642e175e4b22800d8608d4,org.apache.tika.mime,100,7,6196,93
246ab61ce2842d869ef802c04f38527afa907dfa,org.apache.tika.mime,11,14,6193,-3
5d8b457477e13e4a096e72948bd0cbfba494b238,org.apache.tika.mime,14,60,6147,-46
b93c5d7f3e0197eadd71d86470e008b659b86481,org.apache.tika.mime,43,41,6149,2
7d5d6c70026af5d4190c2416c7b937345d506b4a,org.apache.tika.mime,128,149,6128,-21
c47d81ba4fb73cb3a3cecb8255db994bf82a50fb,org.apache.tika.mime,5,1,6132,4
59d94cb616f0d533067aba4ed2bbde30e6bbf65e,org.apache.tika.mime,78,103,6107,-25
51c6242ef778e2c28057e4503350593c84cf68de,org.apache.tika.mime,1,2,6106,-1
8cbebbfd4664471f8ed29d377d7b04f046c3587f,org.apache.tika.mime,1,33,6074,-32
68863177b9037efe53278facf0cd990ce02ce1b8,org.apache.tika.mime,0,20,6054,-20
8d095441e63e7c10793eea10c1d113cde4327f8d,org.apache.tika.mime,45,32,6067,13
9f406c3891706de8cbb3c5e7fc24878c53617310,org.apache.tika.mime,4,0,6071,4
7ece6ff5d3d16a8a4e3180abdff07a817a844a65,org.apache.tika.mime,533,1,6603,532
8d76fd9c2106b55bb08a47a6c71df30e55d54687,org.apache.tika.mime,837,2,7438,835
28327a8e31a226359fc5ade4f743537e6bbc1ec2,org.apache.tika.mime,18,0,7456,18
3ad79a6a21e0039fb451044b2b9e71f83f258311,org.apache.tika.mime,9,8,7457,1
6a7f39d76ea4d2fabd263fbb88f8d5f1244dc863,org.apache.tika.mime,2,0,7459,2
bfc53afebca5af5dd0f103166f890a1b62699989,org.apache.tika.mime,4,0,7463,4
33171a5635184bfcf54afccd72b0dee0529f9f0a,org.apache.tika.mime,23,6,7480,17
6e4a971e7f747f134b1b9a213ef6fb67c6ed5809,org.apache.tika.mime,5,1,7484,4
648b5bf9544ea72be5a9597802a17fc5acb44e1f,org.apache.tika.mime,3,2,7485,1
a918dd64f4b96c362cf3648ebc9fbb6ec4eeca60,org.apache.tika.mime,3,2,7486,1
9d31098ffa9f9779a28a7cee1b471c71f67b4266,org.apache.tika.mime,2,1,7487,1
af2aabb03cd876b9eaf04cf0496290a979b70e19,org.apache.tika.mime,11,0,7498,11
8a5cfcb5ac4030ae39d268a17f5cc8dba6c8ab3f,org.apache.tika.mime,70,82,7486,-12
ccd03400d91ee0d4de39c238cff6d9ef571616de,org.apache.tika.mime,59,9,7536,50
c0a922789617a049cca51a7f3a9ce04f23031b3c,org.apache.tika.mime,16,2,7550,14
64ed1992807eb7af1db53c5e68660641cc8de3da,org.apache.tika.mime,11,0,7561,11
67748e39dd351d4fe37febbd7ea3eabb244970d2,org.apache.tika.mime,82,38,7605,44
19439b7f9e8ad598137036dbb1ff3dd7cdcf7274,org.apache.tika.mime,23,0,7628,23
97549f630d1971525d9b34f9af8b85e57212e500,org.apache.tika.mime,0,4,7624,-4
8d14ba641f5ad442c1c41bcff1c06d5819c1eac2,org.apache.tika.mime,17,0,7641,17
0bda933050768ca9bc876af077d76e39703a6ccc,org.apache.tika.mime,1,1,7641,0
72cc380f6a6419ef20cd591186650607884e58ec,org.apache.tika.mime,179,249,7571,-70
f809f45c1d0fb57d1cc1f3e8c9d47e215f647f59,org.apache.tika.mime,12,0,7583,12
c705865aa307eb7a16e0410f2b90a3121df961d0,org.apache.tika.mime,26,21,7588,5
157fcc98886ec8b5068b663ff7ab4a3ca03c5749,org.apache.tika.mime,7,5,7590,2
007f2d783a13ba309f1c41dfb793060a2c478060,org.apache.tika.mime,13,6,7597,7
21b54bf8ee46073ebc605265bde4ebb771cb9eea,org.apache.tika.mime,14,1,7610,13
6f48f57a6a0f21e6589a1d512a25574425dcc4cb,org.apache.tika.mime,138,6,7742,132
9fe414c334a36c17316edfede1aec3a453d71606,org.apache.tika.mime,4,0,7746,4
a1cd68812630ea7cb4f5998aa3ec67bb70f5337f,org.apache.tika.mime,7,1,7752,6
98eb0b0ec46c8a826a8a76a52636d8cc617d3201,org.apache.tika.mime,25,1,7776,24
c1f7fd7e5de2c31eddf9b0df086d214ea9adf08c,org.apache.tika.mime,881,881,7776,0
70124002d50863050d08b67a60f2bfc6528cdcbd,org.apache.tika.mime,13,0,7789,13
d98bc51e51d8a267e9420bba3675b122a6b1a16f,org.apache.tika.mime,11,0,7800,11
2d822bce6cda2e38b5ebb12af74073df41e8e7e9,org.apache.tika.mime,2,0,7802,2
3620143ac8c694f7bdea31f2e67c26d86a3f18ab,org.apache.tika.mime,12,1,7813,11
af99a319fb9527065a24b7b1b5648368ac33c4af,org.apache.tika.mime,17,0,7830,17
29972fd0e4cfcb772ae465b26b50230313f9c8a4,org.apache.tika.mime,20,26,7824,-6
fbc7bac3b99c368e443903b926b66e9e9cbb4c48,org.apache.tika.mime,12,0,7836,12
36cc24ebd1e83201d07a86d79773274b6fb2dc59,org.apache.tika.mime,11,17,7830,-6
1a564ef51767b8d8117bb9c4f58ad765214cc50b,org.apache.tika.mime,2,3,7829,-1
c496ffa3a53dab8d8992b75e27b7475fb6e407f3,org.apache.tika.mime,105,93,7841,12
ab41dbd982e670df4d8e31ee4dc7b706fe39e637,org.apache.tika.mime,1,0,7842,1
86e32d975d539272f853724d35223edd288822b0,org.apache.tika.mime,1,0,7843,1
3dd12110dad0e5a71555d4e4a0e5a6cd609b0fb7,org.apache.tika.mime,5,7,7841,-2
96a8b1d29adb4a56fc2dae5bf7e5fb41aca0fafc,org.apache.tika.mime,13,2,7852,11
dac8ec870797facb61068b9bf06cd008dbc0ec10,org.apache.tika.mime,24,5,7871,19
d82bca596d70663c9ef138ae0df06d7aebcded0b,org.apache.tika.mime,12,2,7881,10
98c2833a4527b56e0e700423bc832784ca753f21,org.apache.tika.mime,2,2,7881,0
070b58356077dd2d2a277bf9776354a013ca503c,org.apache.tika.mime,6,6,7881,0
f0033c07fe4d82ef15a23872d6f08e109efba473,org.apache.tika.mime,23,10,7894,13
a78e2987289ea5fd6e95f9ce4fef05c59c773364,org.apache.tika.mime,13,1,7906,12
ded569d80e2bd477e0d849513150d14d4165a88e,org.apache.tika.mime,27,1,7932,26
841ede4a2e4fe65d57b84804843977db087f0417,org.apache.tika.mime,1,1,7932,0
6b51782400d51402646aaa226df246d98e06a65d,org.apache.tika.mime,5,1,7936,4
34bb845e679fcab10442c49c02beab7354b68e7d,org.apache.tika.mime,5,0,7941,5
cb914940abee5c9e0289323eb163370ad483968a,org.apache.tika.mime,27,4,7964,23
23130229db0f0e0052cc7b01fe7ffc5855ebd636,org.apache.tika.mime,35,0,7999,35
22c94c97ce5c7a67851d73c83702bfeae8c8a465,org.apache.tika.mime,1,0,8000,1
b13d07e924ccf7e0e0109082358ed69ffb8d9a71,org.apache.tika.mime,1,1,8000,0
8ff03340ae94ca6ad15e00ae2f60c86d5220606e,org.apache.tika.mime,36,8,8028,28
46cda3d023eb2c5fe525b557868e87c531647fa1,org.apache.tika.mime,69,21,8076,48
c2aed15ca6a84c8c73435077fee57a08e990f8a6,org.apache.tika.mime,12,3,8085,9
49a9c4ffeebd479501cba457d5215dc9ec12991b,org.apache.tika.mime,76,10,8151,66
3b10c70971dc07720de331c0347810969ff2ff6f,org.apache.tika.mime,50,78,8123,-28
15bd1d44d3c86a4e5c25d88b30251e3ee13dd748,org.apache.tika.mime,8,0,8131,8
fb732d60934a4132131c89f668b21568799edee5,org.apache.tika.mime,6,0,8137,6
77c6b73798ae18b847792fa80deb71b48a8c38d1,org.apache.tika.mime,12,0,8149,12
2780869d64a4418fba830e6ce598ef01c7c77f91,org.apache.tika.mime,39,1,8187,38
d27bad892615fef5d0fbb988c4c27c5daac8b898,org.apache.tika.mime,36,3,8220,33
c3318a107e894b6c38b5ab753ba999583c8a99b2,org.apache.tika.mime,3,0,8223,3
9dc084c72fb87729f3344109c8a3146cca52dc90,org.apache.tika.mime,7,42,8188,-35
c4c8b2247dd90e0f5ed3b9eac6da471e013989a8,org.apache.tika.mime,22,0,8210,22
de3538527dc7658735a7544c9f904007bc180021,org.apache.tika.mime,0,0,8210,0
5e9164d0a0f1a26cd107b9769f179d38b03d45a5,org.apache.tika.mime,6,0,8216,6
cbd8a3191a02af85c34da9f0bf68184a2ddb66b3,org.apache.tika.mime,1,1,8216,0
609cfe70bd396dc311c694161a59c1ac7076735c,org.apache.tika.mime,7,0,8223,7
7d873abdb15b0a68444f0faaf51e37e1b6479e66,org.apache.tika.mime,138,9,8352,129
a2f30df8bc1e1625cf23ddbc8a3782b7d79f5bc0,org.apache.tika.mime,6,0,8358,6
d2ac303f2222a49cff3af49a86b1b9d8846edcf3,org.apache.tika.mime,1,0,8359,1
82e053deb63a0b9a62c104d84a22e7ab7f6272d1,org.apache.tika.mime,12,0,8371,12
25f7a4d5dac3b7d4bebaed41ef43bf37d1e86814,org.apache.tika.mime,31,190,8212,-159
e910698ed42888d0c30dde88f2ceac7b2f841b98,org.apache.tika.mime,1,1,8212,0
8797f122d2cc17085b0b421010508d6a32c26d85,org.apache.tika.mime,19,1,8230,18
6d7b5d433152220cff25f88b5a28c00154ac5393,org.apache.tika.mime,228,280,8178,-52
d57de4c1a2264aa2ce3a0cd4ea15484faec510ab,org.apache.tika.mime,114,72,8220,42
c57d94dc11723154d94aa33c79a7dad95fd4e06b,org.apache.tika.mime,9,9,8220,0
2e5cd686acbf87590965936cb403db59711ef1a5,org.apache.tika.mime,126,139,8207,-13
85878f6562f9c848a5b4d1a95ad8ccc6296c8af3,org.apache.tika.mime,1,1,8207,0
9f8c762f571417707dfd4cd72446ae2b299f010c,org.apache.tika.mime,57,36,8228,21
5e91e71556b700e9a84fd433bb40d7011c1ef35b,org.apache.tika.mime,9,1,8236,8
a7e1524d4b3e30f70e51d64f084b0b2f19c5b85a,org.apache.tika.mime,8,0,8244,8
9ae596cdaee275b4a11b3839a33373fcc0fa9e2f,org.apache.tika.mime,66,13,8297,53
e3f9af7270d955dd1112d3ac364c2f7f9f397a49,org.apache.tika.mime,24,15,8306,9
fa077bfba10828d5512ede9db89124d252448898,org.apache.tika.mime,13,0,8319,13
a141b273d2b106b3a34227c65327817942357904,org.apache.tika.mime,1,0,8320,1
39a1bac909c86b520467ab9705f56585d03815e9,org.apache.tika.mime,1,1,8320,0
e72a9c4028f3e5d9039e6003c46015752be2282e,org.apache.tika.mime,16,0,8336,16
4885ea7e2eb8a557879a08be9eae85224b718063,org.apache.tika.mime,8,3,8341,5
2d42f07783fa52e1f3064f63e39712698916f2d6,org.apache.tika.mime,3,0,8344,3
96c92f509db1f424147ac0f1b7a5cfcfe6211435,org.apache.tika.mime,3,3,8344,0
e735a659560602a1372c5aa64b3ee2475f0d1a67,org.apache.tika.mime,7,0,8351,7
a78309d0739614ded08803b688ba9683bada270a,org.apache.tika.mime,5,0,8356,5
90d327c0ec329c3c242d374331d04f7acca963fc,org.apache.tika.mime,8,1,8363,7
513dbdb28e0a3f7311e302646dc64bd2f0f3389d,org.apache.tika.mime,19,7,8375,12
50437f30e0a6c6969be162dc1e768ab061e67dac,org.apache.tika.mime,43,1,8417,42
4bd426e403e806d1add41284de577431fe555a6e,org.apache.tika.mime,21,0,8438,21
853fea00ee10fc660470643162e430a5be555560,org.apache.tika.mime,1,1,8438,0
75d487d306d75995484f1d010ab7e712dd2026eb,org.apache.tika.mime,46,13,8471,33
e3a183120a7638ccd2093f62a47730e9636ec047,org.apache.tika.mime,3,8,8466,-5
48b28a6d31c3afb741ffa5ace4c0c4738101b539,org.apache.tika.mime,39,3,8502,36
57a99d012bc43d04ded8e7d88e056680542b405f,org.apache.tika.mime,90,40,8552,50
9e22f46f2403b89dbc8454cefb8b83881f437419,org.apache.tika.mime,1,0,8553,1
e303705a4beab60fe4dad27f29621939fe2f0d0a,org.apache.tika.mime,2,2,8553,0
11184262f9ff36fa4cdda2a88805c0b24a5604e2,org.apache.tika.mime,15,3,8565,12
8584631a0ae23130dd8d3b28454479fc40a443c8,org.apache.tika.mime,37,0,8602,37
b802cc16c4ee760be34c13f899cba2c8170ad712,org.apache.tika.mime,1,0,8603,1
bd764ccb90cb61f40f22a0da1327e29f90590488,org.apache.tika.mime,1,0,8604,1
72564dd2d15397bd68ec4d08cdf45bd1fd7fd558,org.apache.tika.mime,2,1,8605,1
f68f1a4e35941721e21768a60d6aea8827601b5f,org.apache.tika.mime,1,0,8606,1
eb6207836f8eb7a3353aa6088785d22fd3cd4f64,org.apache.tika.mime,14,6,8614,8
84a2a2757c2b8080b450d5341fb20a321a85923e,org.apache.tika.mime,1,1,8614,0
a547dde812cce268518796e116f63ef0a3f4c8f3,org.apache.tika.mime,1,3,8612,-2
f1f4b036714ad08a8e5d52670a5ab334ea86f9be,org.apache.tika.mime,19,1,8630,18
83cee2a7b04adc9de1a3aaa068b8be3843d88aec,org.apache.tika.mime,12,3,8639,9
aeeb366b987b20902c531f5ecac38f334a377d72,org.apache.tika.mime,6,0,8645,6
27fbb0a2303433efb077ec449a591114c264e3c1,org.apache.tika.mime,4,0,8649,4
7d8b3ea972f917c6b2a7deb930bc57a6ece60e96,org.apache.tika.mime,5,0,8654,5
c66a8baa8dba820a7150b48201a5ee97449b872b,org.apache.tika.mime,2,2,8654,0
de7092125649cd61840e27b1f70d68cfab910d89,org.apache.tika.mime,8,0,8662,8
9b1fcfd577232315ffe5c1d39ec40aac4e4879a8,org.apache.tika.mime,9,3,8668,6
28ae6120609d6303044588f6882bcfd72e607843,org.apache.tika.mime,70,0,8738,70
e59e664a5cc17b5a0cc5be27986a5424719efcf5,org.apache.tika.mime,38,0,8776,38
cd6533b19a855d3aeef6243dfae2adece659277f,org.apache.tika.mime,8,4,8780,4
362aa5e1b89de3bb67b9ff212ed69b8fdd16b796,org.apache.tika.mime,2,0,8782,2
6e8f9ea6232844a1bf4625b54deb275f137b7f6f,org.apache.tika.mime,1,0,8783,1
46f742fa5a567ebf5fc07d428de43ea97eefedfb,org.apache.tika.mime,18,2,8799,16
689a717dbcf29f5d2b9804b7ebff6162bc3ec288,org.apache.tika.mime,53,0,8852,53
f15a7fc82495887f5bddc889864d39555c6775b0,org.apache.tika.mime,7,0,8859,7
bb535a0e370a78660bd05da7daf41658f9519a5e,org.apache.tika.mime,3,0,8862,3
c181ed933b85bdccb109cb231e12bc421c2d2e67,org.apache.tika.mime,5,3,8864,2
5c51b4810957da20bcba5808cde4a6260dd6ce3a,org.apache.tika.mime,1,0,8865,1
9e38af6975e80ffdc8ca028f0abdd6ed1e4f5fbd,org.apache.tika.mime,16,0,8881,16
50f56b665e629a7c748b6286fe505be9ded0a707,org.apache.tika.mime,26,0,8907,26
1543cb0f3d1b4877825a923faa1f0f3ae990c4f9,org.apache.tika.mime,7,0,8914,7
3e2a65294894c61051034f049f034cde1322175a,org.apache.tika.mime,3,0,8917,3
0a472d2873be89b333247879fd03e95825ef7a5f,org.apache.tika.mime,29,2,8944,27
6621297537770ca9149e06ee2977483009f8860f,org.apache.tika.mime,31,8,8967,23
ddb997a471a85727b4d59762e4fe2cba7a1fd693,org.apache.tika.mime,532,48,9451,484
7d89a5e455686a945f2e3302f0d201e5e6c4a985,org.apache.tika.mime,55,36,9470,19
09c6122d4cb05da6a3e9d4b0eaaf3d5ecfc33d61,org.apache.tika.mime,15,2,9483,13
b7ada46ce72027b5a5c5a0bd455aaaff38144b51,org.apache.tika.mime,27,7,9503,20
5615ba6f3c478aa576420ce89b5b6119838df497,org.apache.tika.mime,11,0,9514,11
eda4abd3b27de2131f4c1909cfafc952c3483f07,org.apache.tika.mime,63,7,9570,56
3a76e71d0204a14914bcb584c459eda734b5c13d,org.apache.tika.mime,17,0,9587,17
95b897540065ecb8dc1962cf2383a6a3f355762d,org.apache.tika.mime,5,2,9590,3
978cc18f7a2df1b632ee54c75f49af11c3dee1fe,org.apache.tika.mime,1,0,9591,1
b9284758988c9192542f3ddd2e79c49b06ff8af0,org.apache.tika.mime,36,0,9627,36
fb41a4013bac0f225ebf0c61fc34395a70fbee95,org.apache.tika.mime,72,0,9699,72
ed5591cfcc6088b7f22dc5c91751f8c00464f0f7,org.apache.tika.mime,0,14,9685,-14
e4e1f7d24631d713de2ec32779a7a3036c7064c4,org.apache.tika.mime,2,0,9687,2
d1291b6478de7d8325db0453f549ebf69f4e0372,org.apache.tika.mime,1,0,9688,1
1489edcbd0eae1fdf793f1deea74fa3c91bd669d,org.apache.tika.mime,79,0,9767,79
86a6536d666eae925f6bd06d01bee0d344487bd7,org.apache.tika.mime,4,0,9771,4
5016a8352a8a34a2febfcaf580a5dd6646614717,org.apache.tika.mime,151,3,9919,148
d45386ed08ec5e15edc0827459d030d7bdf4e951,org.apache.tika.mime,11,0,9930,11
36f505116edb3ab736570bf6c35c77aebafd4f2a,org.apache.tika.mime,1,1,9930,0
46d0baf90f5314509c572333e6e804e3958369ea,org.apache.tika.mime,14,10,9934,4
5456ae26443600adea79be86df83b1b099112a34,org.apache.tika.mime,40,4,9970,36
a6f9d9d588405d90123aa512b7dccf1323f7a3ce,org.apache.tika.mime,12,0,9982,12
6a41a3a009577a4cacb8d848aa8476c35f583bf6,org.apache.tika.mime,16,0,9998,16
0e4ccf6467c1081cd0c0a72865cc620dd2f3dadc,org.apache.tika.mime,14,0,10012,14
5f62566df57e7cd1f8733b1af02dfb90bb19fb31,org.apache.tika.mime,136,11,10137,125
ade21f4a8519827f8e8794e50c48d6a65f05a8df,org.apache.tika.mime,42,0,10179,42
390d8c3eb4807c0403313b4b221967a12eb4788f,org.apache.tika.mime,22,0,10201,22
d546aa1b926dbeec1c6a2c44a7a1e414d1dfab0d,org.apache.tika.mime,7,1,10207,6
ca9b4b7479b4978bd587452a176470d7c4710beb,org.apache.tika.mime,0,524,9683,-524
76cfbc18533c65ecfc07b3233015b9886938bf08,org.apache.tika.mime,6,0,9689,6
c7d7f66f8c9e389d8654a6a57f0e14040f2e9d51,org.apache.tika.mime,52,10,9731,42
c743609f654435a326c0df657597a7bf61a304ec,org.apache.tika.mime,10,6,9735,4
18a89e9a94571d511368529a80f72d90b17f65b3,org.apache.tika.mime,18,3,9750,15
042ec600f452dcfeff385744f639760e936c2407,org.apache.tika.mime,15,1,9764,14
9ec2aefacdbde3ef0de51d10cc14d7f4a0be9dcb,org.apache.tika.mime,51,1,9814,50
34f7c183ddcd4e859941f41bd97b9118698f9808,org.apache.tika.mime,8,0,9822,8
2d61e41b1604466c5c816f719a317c21984bd1c4,org.apache.tika.mime,9,0,9831,9
5ce1b585a9dcf9bb3a04a2b20dd9e6f5e39c36c0,org.apache.tika.mime,20,0,9851,20
4c6313ff8424a8b8eda7c2c6aa6f9406660ff946,org.apache.tika.mime,8,0,9859,8
b2fcf77acc20e4dcf016b121cb0ccf53ca7ff2da,org.apache.tika.mime,2,1,9860,1
5e320cdda247476e63f065a3e4ef3d4945087399,org.apache.tika.mime,39,0,9899,39
d80fcf1229fd85c579a5ec14fdc3f2cc29e162de,org.apache.tika.mime,21,13,9907,8
ac538c925a3eb2fe9d8ce1b4f216022e84c7af74,org.apache.tika.mime,8,0,9915,8
2a36fcd63ddd3234b7f34e6814972bb62aeb4bc9,org.apache.tika.mime,152,32,10035,120
0eb87d73442571b7e7a66f8fd12236fd8e937594,org.apache.tika.mime,3,0,10038,3
84cc8dc8681a23969ef86e4091ebfc09edc254e8,org.apache.tika.mime,3,1,10040,2
d188a622d4cfd746330f1000a9efe9b21f7dae5f,org.apache.tika.mime,6,0,10046,6
eed505ed34a345345efa54beb133521f942fec18,org.apache.tika.mime,6,1,10051,5
b6f8f9eea0d8bea9827586b2b92239a7c91572e6,org.apache.tika.mime,3,0,10054,3
98c6957ffc4514eeebab6bbaf6ed44ac22c09390,org.apache.tika.mime,19,13,10060,6
bbf9de47de374306b8c0c60a3d12f332ef485f4c,org.apache.tika.mime,12,0,10072,12
52ca7b3f55e466f5d131607e347bbc966ccc1656,org.apache.tika.mime,13,1,10084,12
f81efb5e7f8cdb02331e8d8fa6cece51408e5317,org.apache.tika.mime,35,2,10117,33
ccc0770409aab5474d3130463de65f9e44729541,org.apache.tika.mime,50,0,10167,50
41c6749f7372b6ac3a9acfd309a4aaca3e077a07,org.apache.tika.mime,25,10,10182,15
348c92fec14c4ff66be5d57dc0b592f569acebbd,org.apache.tika.mime,6,2,10186,4
ef61057b0f0ad94c69dd8969177c4f1e0d264613,org.apache.tika.mime,11,0,10197,11
39e87f381226875972b3db87a1de9eef06288892,org.apache.tika.mime,5,2,10200,3
3468cb2894e70140e67eff767292b63e5a44f65f,org.apache.tika.mime,79,4,10275,75
b4c85685e1bb86d61f5d6bc825af7afa478a50ab,org.apache.tika.mime,8,7,10276,1
01726d36aeefe6a187662557cfce587f011973f6,org.apache.tika.mime,1,0,10277,1
5c3070cbbaae9c3d52e07798519fc0b960594c78,org.apache.tika.mime,3,0,10280,3
e652afa255e9310157ea94bd2fa49c6db0d09e03,org.apache.tika.mime,3,0,10283,3
54afc7a6dd4d43dd847d9fab658b4162602e89c9,org.apache.tika.mime,6,0,10289,6
359aae57ce045de191a14bb369e7980154deffc6,org.apache.tika.mime,3,0,10292,3
d02d0336fbc2acf7d0cea2131ed7ad04c054d2e6,org.apache.tika.mime,3,0,10295,3
969804d782a5a882cfa33d544052a36d79995772,org.apache.tika.mime,6,0,10301,6
2f4fbc64c9013c7c46bf6451f2b322afa89af621,org.apache.tika.mime,4,1,10304,3
2d51ad241003f34dcc3b211ea0940fffaaac6761,org.apache.tika.mime,16,0,10320,16
9eaa4fc560810dc689055d0fc80693bc7a3f1dda,org.apache.tika.mime,3,3,10320,0
8e705720888c1abc4062fe96b33f8356ea5b472a,org.apache.tika.mime,36,0,10356,36
390222663ee5b3231faa59039cc71acfc24af665,org.apache.tika.mime,13,8,10361,5
f689fa7ee25c0c9c4bd4d68aa51941eb558f7026,org.apache.tika.mime,104,46,10419,58
051bf86d5126ae12bbb1d72eec441aab55c49a7a,org.apache.tika.mime,18,0,10437,18
d70cbe005929b66a36c375b11f5317b3674cf313,org.apache.tika.mime,10,1,10446,9
1646005f8cfe13d86136d731e48e35ecff9788c9,org.apache.tika.mime,9,0,10455,9
df7b18e3d7bee09eec144133eb678e76cd6f2d1b,org.apache.tika.mime,4,0,10459,4
e011883f38a769b69a8e8b39298fb35dd96bb59b,org.apache.tika.mime,17,0,10476,17
e6821da729d7f002f7a0b3210e0f7f3f2b0f71b5,org.apache.tika.mime,12,2,10486,10
1056aa2b57321b23f50a32810ddea6eeb9a850bb,org.apache.tika.mime,9,0,10495,9
3d1a87ef5795e0a3f10fb1a7154e2176afb46cc7,org.apache.tika.mime,11,0,10506,11
f3718fa956c98be0169b74dd9e9edfe00b90ed1e,org.apache.tika.mime,8,0,10514,8
2377a7c1cd8602457e8e5178884592ff2c502eb3,org.apache.tika.mime,23,3,10534,20
739ac453860b6413278ac96ef4f8b3df30b58981,org.apache.tika.mime,0,2,10532,-2
e500f6ade0182b17ddbc896d484ab0eedf5f9e10,org.apache.tika.mime,1,1,10532,0
a495a10a7d3955278a1b5d60ef26a66aacb7bffa,org.apache.tika.mime,80,1,10611,79
9f1b42196f6a357eb2e7b3f397bfd04d08eefd9f,org.apache.tika.mime,10,0,10621,10
9565b0613f393a81c07887846da912b79381e4cb,org.apache.tika.mime,8,0,10629,8
dbc8f8619b853071983550dcd0398efdde1a5740,org.apache.tika.mime,46,0,10675,46
f7e2453dff899628ed80b4ccbb343e61e31d1419,org.apache.tika.mime,114,3,10786,111
52ccbef8f8a4c9debd66c6ddf85770d5729bc5ea,org.apache.tika.mime,86,13,10859,73
ef0e28d513f08ef0c1c84dbc1eeb9ebca773fb32,org.apache.tika.mime,11,13,10857,-2
e51064f04fd24396af126da7eca44962805407a5,org.apache.tika.mime,6,0,10863,6
79bb58b5c9dd5c50ca4d626c56873eb4415ecba1,org.apache.tika.mime,17,5,10875,12
892f3a8b1e44efdf86ec9aed0887de7afcbf01ea,org.apache.tika.mime,4,4,10875,0
8d9ddf9d7f2b5809b81e262fad3181a4dadb2e57,org.apache.tika.mime,1,1,10875,0
1916f12e068c277f9ef13df7eef44f718d551aa4,org.apache.tika.mime,1,1,10875,0
12bdd1c5b782bae7e6eafbb67a242dae8298f19b,org.apache.tika.mime,13,1,10887,12
14386dcffde35bdb6a233eea46d4bcf2b86f6bf1,org.apache.tika.mime,19,19,10887,0
c19701b5ce47d672000997a8f22d248a030cb16c,org.apache.tika.mime,7,0,10894,7
99b53cec502b9266b1e47aa98170e976aa1ebe3d,org.apache.tika.mime,9,0,10903,9
c56b2752813e60236c9a653d3e4f66bfefc3a60c,org.apache.tika.mime,73,0,10976,73
07597af946d08c88420e55f5204006c34e0a6d98,org.apache.tika.mime,54,0,11030,54
1eb9f970a970638ea4294acb8f3c3ef686b3b9b1,org.apache.tika.mime,9,1,11038,8
d3217c79297111fe2a4ddae0a875450f8868da0f,org.apache.tika.mime,23,0,11061,23
d7156b1f4155c721b608ba2a727eb6105a2558a1,org.apache.tika.mime,1,1,11061,0
0c81e7a4659c1942b189db7c8342964375cda2de,org.apache.tika.mime,3,3,11061,0
44032dea24f5f1d23dd0a53b1a297369e4fe7890,org.apache.tika.mime,71,0,11132,71
3f6d06f8b46a14eba6011d781e5e5a86b5043896,org.apache.tika.mime,18,18,11132,0
d3be3ea26958b015579e170766e0cf61aad78806,org.apache.tika.mime,22,1,11153,21
355da43166cad8ecc62a54deba46b720ff712270,org.apache.tika.mime,4,1,11156,3
7b979a89bfa59b58a8aef16012bf86fa5cd5229b,org.apache.tika.mime,25,0,11181,25
18d0536df5cae8ad9d59a17d69ac9c3dc7788c90,org.apache.tika.mime,0,9,11172,-9
d9f730cbe9b9b93fc54d42c1f191091537ddfa3f,org.apache.tika.mime,1,0,11173,1
60059aec3f7b41272c0f069812988eb4950e9686,org.apache.tika.mime,10,1,11182,9
7ca5ec0aecea4092b6a8399638444ae4a335137c,org.apache.tika.mime,2,9,11175,-7
2a26a5dc179b34d5b9ae845c5d60fac9806c3695,org.apache.tika.mime,2,2,11175,0
79c07dfd9e4eedf90328aa9409017ed8a8e82bf3,org.apache.tika.mime,8,0,11183,8
281fedfc86acbb5e01015f1462a27a86a65403f0,org.apache.tika.mime,1081,0,12264,1081
3784cac1f447ccf71c645361335407cf8b65b6e7,org.apache.tika.mime,7,5,12266,2
66d39b784d2cb9d8def5c572ee338b422c5905ae,org.apache.tika.mime,951,958,12259,-7
345d33f0b53110047b9a2170f6ad720751fc8386,org.apache.tika.mime,17,2,12274,15
03203f1786565037011d1d6af2e5aa3c4b4fd6b0,org.apache.tika.mime,13,0,12287,13
77a5e1279f29956ac9a0b5d7271627875f500361,org.apache.tika.mime,12,1,12298,11
2259e44d88e01cb95a241e1ae3a7365ea600c974,org.apache.tika.mime,1,0,12299,1
fbd9142b7b0fd30c677ee8928a1b122323621ead,org.apache.tika.mime,23,0,12322,23
e549ec8d5d52510f38ebe3719dd02c5d5876199c,org.apache.tika.mime,2,1,12323,1
fa1c631ae4c705d49710175af049de9358e5941f,org.apache.tika.mime,35,12,12346,23
db9ac567f053b3e540aa9780a29138494eef07f1,org.apache.tika.mime,12,0,12358,12
a1b849f3c11f03a83aeea1e1020bb57b0fc98143,org.apache.tika.mime,2,0,12360,2
482c7f88d296cfd60c3e7ab72c39d687f9ff0c4e,org.apache.tika.mime,2,0,12362,2
78ac030b6e8f4051f8eaf23560f3ec72829c2b6a,org.apache.tika.mime,8,1,12369,7
64a268ae6890b9f6a6983d691233b5f456222211,org.apache.tika.mime,4,0,12373,4
06cfbaafeb308bd979fd2214a4b1a15353a9b4ab,org.apache.tika.mime,1,0,12374,1
de5a2dec6924ebe01e4bf323a98abd208cf9aa7e,org.apache.tika.mime,1,1,12374,0
d2e68d44cb224ec2077d5cc4961420a5cc78de36,org.apache.tika.mime,45,8,12411,37
28149a6e9c700e6c81f266273cf3381ba5805526,org.apache.tika.mime,13,10,12414,3
7cdf08c56bbd381b8b216e8e20183fad149aa984,org.apache.tika.mime,5,8,12411,-3
0eeab40fd953377ae0fc4783ce3be5afe2622d78,org.apache.tika.mime,2,6,12407,-4
3533866db78394e6e45b4341a82ec1b1f884516d,org.apache.tika.mime,21,38,12390,-17
8045b054b612d9e4f8449e9c2ab1e4dcfd84214a,org.apache.tika.mime,17,1,12406,16
f71910e2e00b55fbfd339e6d682521f64de0c696,org.apache.tika.mime,28,23,12411,5
d5981c7079c23c58dbb91aebce30de5498f51b8a,org.apache.tika.mime,9,6,12414,3
e349b4fb6cdb37b5dc2e7c2344a038d392e29c79,org.apache.tika.mime,8,0,12422,8
8938fdfa93f8c0647e547e8a04a187fbb5a32603,org.apache.tika.mime,17,29,12410,-12
e7a3a49561cc1f9ffa4cd34307005f559dcefe19,org.apache.tika.mime,6,0,12416,6
193b5bb6951838019c64cc73c416bf0a5aa46741,org.apache.tika.mime,1,1,12416,0
1996cdff2d95a8df407a0d5f0ee89f1115a9d2f9,org.apache.tika.mime,7,0,12423,7
96980ecd4dc30c05a356b678b23204e5971e2cb3,org.apache.tika.mime,4,0,12427,4
f949ddf219d227e4aee9aa9ec6c8599babaf3cdf,org.apache.tika.mime,10,0,12437,10
4bb76d3eb14b14fc8dcf825a9a12eeb0ea28b7ad,org.apache.tika.mime,3,1,12439,2
9e9ea27a665506579b329c66bff9934de19e6128,org.apache.tika.mime,28,0,12467,28
9c6f81c1140736f5e3f5d19904bd1b3a00bd2538,org.apache.tika.mime,4,4,12467,0
f73655a020088276176c79359f8611f7eadc4378,org.apache.tika.mime,3,0,12470,3
efaf482f4e5fb56ea7d9b73f74c57073dd768976,org.apache.tika.mime,29,0,12499,29
e9718f90513f1a4cde62e79794089bc45b35e4af,org.apache.tika.mime,7,1,12505,6
784c0a466f577d800ce68b1612c6cb7c58ed84dd,org.apache.tika.mime,4,0,12509,4
f35351e410e56e119e38be98e55fa564aaa5c604,org.apache.tika.mime,22,8,12523,14
6a092332686e02ba26456e52fb0ce8bc5b42be56,org.apache.tika.mime,35,0,12558,35
046e43f81c37f0ab92d9420fab8b645969d5a13c,org.apache.tika.mime,13,0,12571,13
d740f5d8b2e42b1db42806ddd395e034cb416fd4,org.apache.tika.mime,11,6,12576,5
557b3704501a9692809a3e1b7838866786ed3366,org.apache.tika.mime,12,0,12588,12
1b14b39d3e1b453620b2f7b26a933103a78c958a,org.apache.tika.mime,8,6,12590,2
f054bcd1a0a57a730ebc53e7a2cfd4215a7526fb,org.apache.tika.mime,36,6,12620,30
7ebe007ec03088449f67619ef1e6cb564178b14b,org.apache.tika.mime,6,8,12618,-2
602d237feec48bfd97bc2b2b38ea614b1ae2c55d,org.apache.tika.mime,2,0,12620,2
780100767e24505a24595ea6db43978d0700e220,org.apache.tika.mime,15,0,12635,15
46deb4dbb891f03db6395a1d1aa1f297d5f71491,org.apache.tika.mime,6,0,12641,6
86579ec5644ca5fac47d945423b824d8ca7b0c57,org.apache.tika.mime,11,0,12652,11
e5d348ddb9727e67666d39eb1b10e6feb633022c,org.apache.tika.mime,6,1,12657,5
355a7d13e96608033c9f349048bacf6dbda73aaf,org.apache.tika.mime,9,0,12666,9
e105088729ef12acbda1fe4e71f462f84d98f981,org.apache.tika.mime,2,0,12668,2
1299c9e494882e011749fb8a4514c40631df03d1,org.apache.tika.mime,2,1,12669,1
bee1a87d7d9ad3a1c5f45cf65082b9505dbe9fc0,org.apache.tika.mime,14,0,12683,14
f7d3097fb6581d989195b51bb2bc4302ad9bf24a,org.apache.tika.mime,5,0,12688,5
74e71ebd871172c3473719d0814400f69d4c8913,org.apache.tika.mime,14,0,12702,14
260d77be050f0f65bd8920b6b744e9857c112f53,org.apache.tika.mime,4,10,12696,-6
db1c0e6ab1652ec376613b88916b430c215f892b,org.apache.tika.mime,8,7,12697,1
c94236a8365b9ab1491d98c31819a85b065a9fe1,org.apache.tika.mime,13,8,12702,5
01109c8fec3a736749b9cd2dd741fbcc936cbf4c,org.apache.tika.mime,13,8,12707,5
d184e9b95d6c066fc3445c4d766263c1069f6685,org.apache.tika.mime,14,2,12719,12
81bc3cd14464e79571799faad970de0b7d70c41e,org.apache.tika.mime,14,2,12731,12
172c58443550d256a94994aba24c6600a2397256,org.apache.tika.mime,11,9,12733,2
da1fe243ace68cc2b5c4bde022113233ad95ea15,org.apache.tika.mime,25,11,12747,14
b47c36453ded0cfe4b17625fab4a7419da5c2a7d,org.apache.tika.mime,9,0,12756,9
d40f8d40bf9458e664dbad2ab797718eba828fcb,org.apache.tika.mime,9,0,12765,9
3f1d6ae5b26a3d91beaf89d63c1ca53c47003cfc,org.apache.tika.mime,6,0,12771,6
9730a36248926cad7ba3a2047e2e1e75541f0c7f,org.apache.tika.mime,13,1,12783,12
1f96a0e9446fbd89fd724f12f103665b6250f201,org.apache.tika.mime,6,1,12788,5
80b27e6d843d221de87591d34632e546c0d23b1a,org.apache.tika.mime,54,11,12831,43
0cdf17df913cadf23c8074d46d386fa230f8198c,org.apache.tika.mime,17,1,12847,16
585ab9b93d5b197db67ac736c2ea0429547f91c3,org.apache.tika.mime,17,1,12863,16
567f7f7f11a04c31e62302ebac3841a0a5d050b3,org.apache.tika.mime,9,8,12864,1
fba811b830a2105095efcdc267b5843c29932e7e,org.apache.tika.mime,1,2,12863,-1
4aff4839aece41a739b93169cf7a475ecfc5c70c,org.apache.tika.mime,16,0,12879,16
d447193f29531df3022f5137b8f0ec1c73e58cc8,org.apache.tika.mime,5,0,12884,5
114b6044a74fe463b90712345ea8e3b2cb085b62,org.apache.tika.mime,4,4,12884,0
c1a3ce0ee108d865beaa765bd169fa9b463135a2,org.apache.tika.mime,21,0,12905,21
bc0b1f7f7e0b854a119779fc3f806e0d9490c08a,org.apache.tika.mime,15,0,12920,15
e08d00654a77267686a112e0665c324ef041c033,org.apache.tika.mime,12,0,12932,12
74085318373082e3b4662481eb78e62a07726ddc,org.apache.tika.mime,0,11,12921,-11
e780d56652d48dd0f50b4e62a58153e95f055022,org.apache.tika.mime,118,21,13018,97
e74f66375f20d914f8585597b6d9492586a0caa9,org.apache.tika.mime,9,0,13027,9
ea47b716e5a7a1a1637b1cef0dc439b140590711,org.apache.tika.mime,9,0,13036,9
4d308fd7015391c9cdfd13ba6990dcd6e8496138,org.apache.tika.mime,17,0,13053,17
d405172c89f0cc94135d09b30c3c6ea135d6a5b2,org.apache.tika.mime,13,2,13064,11
01a9b6db5ac20a63f2b9de9c15de1b12ee2bde06,org.apache.tika.mime,12,0,13076,12
acf031a06faac4061eced224dfabacba6e6fed8f,org.apache.tika.mime,9,0,13085,9
6291648dc5ddece929be0e4e7103019d615006b3,org.apache.tika.mime,3,0,13088,3
ade60ed6277f6b489995c70f521dd9c17f6f608b,org.apache.tika.mime,18,0,13106,18
d9dcd59ae01c6ae2c8bded94bc9b04d795face9e,org.apache.tika.mime,72,2,13176,70
027625dd71fe9f5c33a546b7395aee744adb2ae0,org.apache.tika.mime,72,2,13246,70
52ea9ba7c2e3c99e7a2d4fb38875caa996438857,org.apache.tika.mime,7,1,13252,6
81279a1e08df3ecd430e979f35460630cdc1bc4f,org.apache.tika.mime,7,1,13258,6
be8b433d2994af4e0d95de3bc5ab4fea99ee6bcd,org.apache.tika.mime,17,0,13275,17
fe559b80bcad1f107904ca7a89724a26ea2921a1,org.apache.tika.mime,109,3,13381,106
72d2d88b381ba75942ae791042ef54af33ee1f38,org.apache.tika.mime,17,1,13397,16
f5b04b60c472062ab46a0a19eb75d3a39e80fc76,org.apache.tika.mime,17,1,13413,16
3c0abc8ebebbaa54a716fbcd15eaf8057343842f,org.apache.tika.mime,52,0,13465,52
2222fe0ce2e1db633bdcf49bd7b24941374f2033,org.apache.tika.mime,10,0,13475,10
1c0e60035d2bfa4857c0e48742754aa904727520,org.apache.tika.mime,62,0,13537,62
d50a69361bd0196fb2595313cb47222f61701ba4,org.apache.tika.mime,79,1,13615,78
d647a234783bbc3f83d3691a1e1d5788c438d55d,org.apache.tika.mime,8,0,13623,8
81fad8c97e60a3de7d926dc4ce10cbd235549583,org.apache.tika.mime,6,0,13629,6
533572b6a7169b8202e591b5d31823dfd6f5c245,org.apache.tika.mime,6,23,13612,-17
87c2ef3191d0a86502dc249240022b3cc973aaa4,org.apache.tika.mime,31,4,13639,27
7a5b98319dadd8fcb2913ee9bc6f98787105db13,org.apache.tika.mime,31,4,13666,27
d011d708c21669759af86e855b61d98dae19492e,org.apache.tika.mime,5,8,13663,-3
df14f78e46feeae16cb6cbd2cb40c44ce497d53e,org.apache.tika.mime,31,2,13692,29
009c143aedb95e356b2835b17fd66e9f7aec43d0,org.apache.tika.mime,8,1,13699,7
aa448a3b7e61f9a46efd1bf3f2ac72e6a3852d8f,org.apache.tika.mime,28,4,13723,24
84a37209e1c6e27491c9e828799919bc32f8787e,org.apache.tika.mime,34,14,13743,20
6c3e5dbb58fd0a005e39281bfbedc972c79ba2ec,org.apache.tika.mime,37,1,13779,36
ef1d9077bc9312e796bc00b6a00433cdd5f23c2f,org.apache.tika.mime,9,0,13788,9
e6cbaa03be9e362c6572f6cde351e777abd4c763,org.apache.tika.mime,15,0,13803,15
9fdf9a83324ead9b86e09318735852dc6e3f527c,org.apache.tika.mime,15,0,13818,15
a38a2b093c7f4f1128dd987663c4406fcd019cd8,org.apache.tika.mime,20,7,13831,13
00bb6f4ff28bf68935450966f25e8777367057e0,org.apache.tika.mime,24,12,13843,12
9477d03e10149a8ec6b5d6889e2fd2317d2ed5f5,org.apache.tika.mime,24,12,13855,12
847156ac0f5fa7d4cc06964198359cf594b66d50,org.apache.tika.mime,10,9,13856,1
e6c0082e41143a01f0bf646a8a8b6c06a85ca239,org.apache.tika.mime,15,13,13858,2
90bf4f6e4c645240b36ded6973eb64961312fc0a,org.apache.tika.mime,18,15,13861,3
7afcfc702e3097f652a0ea21c368f7632d2abf3e,org.apache.tika.mime,43,37,13867,6
c5130ec612ec3c46cd4a7d86153b4c6e4b8cf57f,org.apache.tika.mime,10,0,13877,10
73a37a4c2e7a1c20faf779d1aa1b43fb554cc21c,org.apache.tika.mime,17,0,13894,17
da8363fe62c490e6ec669e57ba19e9a49a9ddbcb,org.apache.tika.mime,27,0,13921,27
bb82205eece0eb68edee7d7ac24f63cf3934198f,org.apache.tika.mime,23,0,13944,23
40647ea4e929683ae41422bdd3144cf84f24d0e0,org.apache.tika.mime,9,0,13953,9
adde0121be73fd5e57cfe7be6de38e61e9c32c27,org.apache.tika.mime,32,0,13985,32
03035d67156e3f2632e4ceef9158eae675f01734,org.apache.tika.mime,7,0,13992,7
a405fc40c6fd348b4d5cdcf77ec8143d261ab923,org.apache.tika.mime,17,0,14009,17
e568bbcfaccdc56c8d917e47e4f6adcbdd46ccc2,org.apache.tika.mime,7,0,14016,7
70d2455c4ff7c54afe6762d5b50653b8de06f2b2,org.apache.tika.mime,7,0,14023,7
0d3eb1fd04b11e184252f6648453d86e90ed7e0a,org.apache.tika.mime,17,0,14040,17
3cc4bc2339ca02a1f6879d1a22bc7cd31411d566,org.apache.tika.mime,17,0,14057,17
e56e2b2915e8cebcf97c69cdcb3ecff861434f61,org.apache.tika.mime,499,61,14495,438
6b174ecbb70d1236bdb9886f86bf94f51d3dd881,org.apache.tika.mime,24,0,14519,24
c020e48a263e2b2a29543ccc4a1946be8002c7f3,org.apache.tika.mime,0,17,14502,-17
916e5eda42bb2d56fec45d2a43647514bd254296,org.apache.tika.mime,2,1,14503,1
f8f407a715f9327533afce624f2e666a1219e6b8,org.apache.tika.mime,2,1,14504,1
134cb3812aba88152f665c1d14ff65092f21d051,org.apache.tika.mime,2,18,14488,-16
ebb4bc6d7bf82fe618b7a4b5f4e9b4278b96c0d2,org.apache.tika.mime,2,1,14489,1
bada130efe32560a5b3c26472029f3bd536040b8,org.apache.tika.mime,5,2,14492,3
443bc7d3332bb495872cea72c622b043cb2192f9,org.apache.tika.mime,5,2,14495,3
b618984cc78df5696886404c6579d2bad71e1bb8,org.apache.tika.mime,7,20,14482,-13
0815b2144cf013e1a0803cee72d8076e8c544716,org.apache.tika.mime,11,5,14488,6
d98bec077bbeabe095d9200f6b729b465e51368c,org.apache.tika.mime,2,2,14488,0
383015235d4fc855c16d8d65c0c3cae96488951d,org.apache.tika.mime,26,4,14510,22
24b54af4d74ffef994cc5708b30bd516f01b346f,org.apache.tika.mime,39,11,14538,28
8d8e818cedd6727a9ff43572a31aad83b9537350,org.apache.tika.mime,6,0,14544,6
da7ade6350edf603e0caef03827eddc357e636ab,org.apache.tika.mime,6,0,14550,6
dd7acbf6c43dcd2e75323755e3a5365e454b2274,org.apache.tika.mime,12,0,14562,12
2e7a4f5a976ad07284b83b9bc0e61ce63349cac7,org.apache.tika.mime,51,11,14602,40
bea5b9d0d88f1524fd58d8c82448686575bf837d,org.apache.tika.mime,19,0,14621,19
068c87cc11c338c87576bf8be25bff736539ccd6,org.apache.tika.mime,19,0,14640,19
0277fbb92c4714361949d59708db2a8734f1b1f2,org.apache.tika.mime,2,0,14642,2
0579efe59c35a4db248d8a5547af05fbee3caad4,org.apache.tika.mime,2,0,14644,2
00221ad34a18f501d967979288236b98bd4cec58,org.apache.tika.mime,1,1,14644,0
4455a6f087bbd52767e55478e9d51fdb39adbce6,org.apache.tika.mime,14,4,14654,10
3621ee4abde21f66ebab200ba2788e160b8df65d,org.apache.tika.mime,93,17,14730,76
67e2c5a80bc884818c3f905a26c396c57608d75f,org.apache.tika.mime,18,2,14746,16
70ca280f11fe4127df290b8027c6bc1d5180271f,org.apache.tika.mime,57,0,14803,57
582083e003efe45bd9e2e7a624a4177c9f1ddc50,org.apache.tika.mime,57,0,14860,57
7dd38d5500c539328e2b0a083e1998a28e680539,org.apache.tika.mime,57,0,14917,57
7914318c5eab2b5a03adf419d0e330c1a978227a,org.apache.tika.mime,48,0,14965,48
b5c07d523292338a7f01d07ffd4ff63fd2e8ec9c,org.apache.tika.mime,3,0,14968,3
1fd441e8d71169b8d6eb8cd8d1c42b59a5a119b8,org.apache.tika.mime,0,7,14961,-7
e6d332d1335ce33395ca403648ad955f4c97e622,org.apache.tika.mime,46,0,15007,46
85d25ccdabc01eb0cd69c7e764df98e92688e51b,org.apache.tika.mime,1,1,15007,0
c8deb97fabe579f05acc12a02adf30cf92c7c4df,org.apache.tika.mime,11,9,15009,2
817f84843ffbae84def86c044a9f4f453f74a5b4,org.apache.tika.mime,13,2,15020,11
c5f0de1a83471ac2a15c46b1c39b33904dd69c9f,org.apache.tika.mime,0,3,15017,-3
920f68266d67ea35f7084ebbd21a36fb0ddaeb23,org.apache.tika.mime,9,9,15017,0
5e6b2c60c62a4a5f3219d06618cc26dd4b791f56,org.apache.tika.mime,11,5,15023,6
be9d440e05e609f85efa151b8f5fc78cd0d30fb9,org.apache.tika.mime,1,1,15023,0
6744383d71eaa99aff8b590110aac51967806d13,org.apache.tika.mime,8,0,15031,8
450ab4bee5b91663c8d524ad1f6357147c6cd40f,org.apache.tika.mime,40,3,15068,37
ad23d84f88abe6e540e989c988142f1ca0c876a7,org.apache.tika.mime,17,1,15084,16
b5f5403fb150f2a290fe1cfa10a6fe572b1dd50a,org.apache.tika.mime,114,4,15194,110
97699598f000139b1222b785d634b3c8a8e216c7,org.apache.tika.mime,20,0,15214,20
700b38acb6443c30b4b05312a2010826fc618477,org.apache.tika.mime,6,1,15219,5
10cd2055b43c6983aa4e7d95da53680355f39bac,org.apache.tika.mime,40,2,15257,38
cadbc405519e5adbada1ddb6d2d4beff1f953072,org.apache.tika.mime,11,0,15268,11
ac2c024cee1e8475c056196aae0526120f99a85b,org.apache.tika.mime,76,2,15342,74
db75e85fc9cf0d5f2c25f7eae2ff8deb59611b00,org.apache.tika.mime,16,1,15357,15
1ba30ef32fee372566790650e9ab8a36bc9ab807,org.apache.tika.mime,8,4,15361,4
d72ae53d2e1c767c1e5c6d150bb87b33829d10f0,org.apache.tika.mime,14,0,15375,14
10a8eec119c7a77be76000b30aaffb96a552cc44,org.apache.tika.mime,30,23,15382,7
e6e3b8817053e981f3843f1d3b7055b4ae30ed73,org.apache.tika.mime,30,23,15389,7
dbf35b6b4eff1cdcacf6a1265bc025c3bc7a6dd0,org.apache.tika.mime,6,1,15394,5
48a4ab9849181cfe30acc34701325d3cc4a9431d,org.apache.tika.mime,6,1,15399,5
8289d0b704514067a57928905b3654486b5831eb,org.apache.tika.mime,23,5,15417,18
3701f2d340ee56af10aa1b6cc44375d71b50bb52,org.apache.tika.mime,10,1,15426,9
09031046e5bece75ed22d9ee9b184ec49a14f99a,org.apache.tika.mime,4,0,15430,4
9b7154cf37871f5ef0874e972ec9208538e15e44,org.apache.tika.mime,95,4,15521,91
9c01111a822419797f20a09388ccd235c7e70db9,org.apache.tika.mime,4,1,15524,3
892e38d5aba4e9f1480bce73802a2c2616da1db1,org.apache.tika.mime,9,2,15531,7
2cb195a7433fed2f7b37e46942316eedc924af52,org.apache.tika.mime,14,0,15545,14
742e60e20363aa66db992df4d1cae26b18060f45,org.apache.tika.mime,23,2,15566,21
ceb7b42ba2e342e7becb81d0c661ccd6209a915e,org.apache.tika.mime,3,0,15569,3
bf2846dde776c1cb55c2ae5f9cbe8d8f4f663dfa,org.apache.tika.mime,3,0,15572,3
48d26503758cf25e482912137d0157594198ef60,org.apache.tika.mime,1,1,15572,0
fb1a85ba1e5df0da997468b1da5c274a46011a2e,org.apache.tika.mime,1,1,15572,0
ca3207c3b0dd408b32a07b70dcfef42aa4d0a9bd,org.apache.tika.mime,19,0,15591,19
4b38d6228f4ba5ee912735dc692275499bbf45f6,org.apache.tika.mime,106,7,15690,99
e24e6afb1c2a37be266839767115ad6adc5f8dcf,org.apache.tika.mime,2,2,15690,0
536df9ce90a18ea6e8827e704e54afe162719953,org.apache.tika.mime,72,22,15740,50
43b84c24fa26520ab0a4edcef1accbf49f23b101,org.apache.tika.mime,121,7,15854,114
eb33286282a3cb17ddd3b1911738e2068fd4d742,org.apache.tika.mime,3,0,15857,3
7bd88f6eb2eb6035dd20f54364f8eeac7e2df0fd,org.apache.tika.mime,27,5,15879,22
e7b481dd763ff4f586a94b981281923e4604010a,org.apache.tika.mime,27,5,15901,22
aac3af4ccb9da07b1ade1a57ed5e015dbedb17c4,org.apache.tika.mime,25,9,15917,16
0e39bceef4456eb391ace48fece2ebce52e0824d,org.apache.tika.mime,72,22,15967,50
b26a0ccdbd5620b870df0dc434d2f9265b2df082,org.apache.tika.mime,3,0,15970,3
3d5d4d8b9667a31e3cb30a9d02543347feefbcc7,org.apache.tika.mime,3,0,15973,3
9a2c7d89e03ca7c0e821b69c394165297edfb9d4,org.apache.tika.mime,20,2,15991,18
429b22b2ac9ff96cfca714895d65dce311522616,org.apache.tika.mime,3,3,15991,0
a0546b6cb98c949bb747b2e0e8d5675f651f6a16,org.apache.tika.mime,3,0,15994,3
6e3c26e45b1af10cd16eeb54f420826cf1330771,org.apache.tika.mime,6,3,15997,3
1ab34b647463e0a6a4a12d9939bf01bcc71af352,org.apache.tika.mime,3,3,15997,0
0ae7a6f7649b7080adf72a42888dd1a9d12dc2a6,org.apache.tika.mime,3,1,15999,2
6a366e51fcab9c53ce29e336c086944315959d95,org.apache.tika.mime,1,1,15999,0
614c4c2c9ceda24664edd3e27be1312dd60d6d38,org.apache.tika.mime,3,1,16001,2
c3685d0767837a02cda93cfe49d81c31e352191d,org.apache.tika.mime,0,10,15991,-10
80b533b86cf8e4c8e090e95479ef60f2a641194f,org.apache.tika.mime,8,0,15999,8
e808d3fa0045894bc191c5eaec61c761aa21364e,org.apache.tika.mime,8,0,16007,8
e73fbfaa6aa46abe85dc9f561d802d68f6ed4d5d,org.apache.tika.mime,8,0,16015,8
31304f8ba1aad16d76c3381d25efc245c32743e8,org.apache.tika.mime,10,0,16025,10
f05749404eeafe67dd32e72cb284960a9425cbb5,org.apache.tika.mime,10,0,16035,10
f4bd11b84bd82fd072e5c4e246ba391a2ffbb5ff,org.apache.tika.mime,6,0,16041,6
4fc63fa02282aa02d5dd2f357d608a4f736f6f6b,org.apache.tika.mime,6,0,16047,6
0758598bece92f97418f88d0c443e8d9cff7a7ee,org.apache.tika.mime,40,0,16087,40
433a8c1625d302bf1a9d81f2ad1223df7bf83d31,org.apache.tika.mime,12,0,16099,12
8d420b60d89e3f3da90d5579bc2d4d2f974354de,org.apache.tika.mime,18,0,16117,18
9800dac57fae5e6919eeb42e2502a28b22590145,org.apache.tika.mime,8,0,16125,8
b7a1ebcd1effcd1d9f61dd74b96c71965cddf841,org.apache.tika.mime,9,0,16134,9
1623adfcee0d1aee25812edf41a929a03bcf47a6,org.apache.tika.mime,1,1,16134,0
c85f5cc4729f1d6bd81c24bab375e89fd1037237,org.apache.tika.mime,18,14,16138,4
f5571fa99ef6f178a16bd1bd3a3cded83c7b0013,org.apache.tika.mime,18,0,16156,18
0d259bc8b6beccaa9bac2e85212b57a48f171e83,org.apache.tika.mime,5,1,16160,4
c89fc0c95937b71e9c1a1b5905f34e0dc1cb650f,org.apache.tika.mime,28,0,16188,28
7b83f7538c788af4cd1c9e997e64dc550e733dee,org.apache.tika.mime,14,1,16201,13
0bf11aec86079b8f1ae2f1ea680910ba79665c4f,org.apache.tika.mime,5,1,16205,4
e9d62d24c19250053aee07a59c9e4de5197f2f42,org.apache.tika.mime,11,0,16216,11
114009165410c91b57b91fc4eaddb089a8559451,org.apache.tika.mime,7,0,16223,7
f233f3bacb5ec62c948f46d51c2a1ab54744073f,org.apache.tika.mime,2,2,16223,0
f52838fd0c88c4c843c2cd778fd32ea7184bc902,org.apache.tika.mime,5,0,16228,5
1e02f01819ef44bc99a5fe81e271e67be79b98ad,org.apache.tika.mime,10,0,16238,10
f26ca4699331640c1f6ba0512c199db229f80a00,org.apache.tika.mime,10,0,16248,10
de195e14f927cee1ee68365aa691221060c2e2e0,org.apache.tika.mime,6,1,16253,5
d9dbe0c8ca20b5954f04b0633ec1e34bd5ffc4d9,org.apache.tika.mime,32,0,16285,32
57b26e9756c59efc08eb180636460457855ccf95,org.apache.tika.mime,17,0,16302,17
cd90587f5d194c1f0e9b5cd5eeb8a995ecb3868f,org.apache.tika.mime,3,5,16300,-2
1015c362ea64691d90c03bf227aabf5a35b822ef,org.apache.tika.mime,2,0,16302,2
62fe4ada48f961ec49a41f6b67f28a64681c9b93,org.apache.tika.mime,7,0,16309,7
995df88a334b7e8508a680c4f2800ffb2095c041,org.apache.tika.mime,20,1,16328,19
b53afd70ab279b77c9bde6906e187b3dfe0b03ca,org.apache.tika.mime,1,1,16328,0
7c68eb2ec3d42f97b666c2bb491b8cdab7975eed,org.apache.tika.mime,1,1,16328,0
4e057270f075a36e535f55f1542972d6fa566dbf,org.apache.tika.mime,429,42,16715,387
114f93e61f91e83bc029f35ccd2421bca585f91d,org.apache.tika.mime,28,0,16743,28
cb5f4103c00b91d55f3974959e4cb444549dad27,org.apache.tika.mime,14,0,16757,14
f9104d17ad0b92b243501fdf0863b4ccdaa5e791,org.apache.tika.mime,1319,1314,16762,5
6b7d0ad97c47e0c91ebe3399805fef518e282d52,org.apache.tika.mime,2,1,16763,1
852b974d215f7550ab667171af44086bb0d34437,org.apache.tika.mime,40,0,16803,40
d4a39b4873d939553e0742487b8c84f072497c1f,org.apache.tika.mime,16,0,16819,16
a02ee9821339441c2fde40ea483e850d99ad0ba1,org.apache.tika.mime,19,1,16837,18
b5c3485e9f1c390565ccc0abc5e4609fdab9bd0a,org.apache.tika.mime,28,22,16843,6
c10229588800e6d56907a19abc3d116b4b423169,org.apache.tika.mime,5,0,16848,5
c3fff83c7e955ff5de0e4cb9098b06a15ee2cf7e,org.apache.tika.mime,25,1,16872,24
ecd1d62ad9e4d2ddd53abf204539e5d765e6c624,org.apache.tika.mime,25,1,16896,24
eaa712f89d5de9ad06647fa29d10ac1baa47a4c0,org.apache.tika.mime,34,5,16925,29
b0ae63a1c59ef60ac6b134cadf2053f2e73152d4,org.apache.tika.mime,34,5,16954,29
c6b30c578e98373496f895cd7caa8317f4212d51,org.apache.tika.mime,46,14,16986,32
fa1b2ef87157f51797d0dcaed36ebc990e538910,org.apache.tika.mime,46,14,17018,32
75c2ff5686a70c0fb15c4b52534c1be09669af1b,org.apache.tika.mime,6,5,17019,1
618345263ee41108e1a225dbcdbb8db16b2aae28,org.apache.tika.mime,6,5,17020,1
f29362d91b46864a7f924c60f7cf691ac18f11b2,org.apache.tika.mime,1,1,17020,0
7595d820633d2588234b6650ab36265a4dcdfec0,org.apache.tika.mime,1,1,17020,0
7ed64a5bd8e564bbe8fce0948a71c1db249fa2fb,org.apache.tika.mime,2,2,17020,0
9ec102102119e6d398c53652e1a28c2c61600f5d,org.apache.tika.mime,2,4,17018,-2
6cd1a4a5df54e44a0f17e2035ad9e83812edd613,org.apache.tika.mime,1,1,17018,0
8dbb5736fa92b323e270e2075b42dce458a3abd6,org.apache.tika.mime,0,1336,15682,-1336
a43784b19f6b0955478dded71521b0491d21c90b,org.apache.tika.mime,1336,0,17018,1336
8b82b4c942c82f9cc2eb393e669227606b5f15fc,org.apache.tika.mime,6,2,17022,4
6e3ee160366ebd6b336d7b9f12984486a3bb886e,org.apache.tika.parser,3075,0,3075,3075
2b86daf8815f3c8d974f887e4cc064b9159db595,org.apache.tika.parser,4,5,3074,-1
d7dabee5ce14240f3c5ba2f6147c963d03604dd3,org.apache.tika.parser,17,4,3087,13
780f13d348531efbda8da1fd11c51039e50f29a9,org.apache.tika.parser,40,48,3079,-8
53f61c8270e23cba731fa7186ba597fcc1f454d6,org.apache.tika.parser,0,1,3078,-1
9f4c38c25babaf67a94586e2255ec09aa76ea2b4,org.apache.tika.parser,74,69,3083,5
32fda63e7bfb1722a3e35d717f68e3242a259c47,org.apache.tika.parser,19,33,3069,-14
f8183f2dffaac516ea48fc3522c302fa4937b26c,org.apache.tika.parser,15,15,3069,0
0c203842869b08afd0d3af2a899f6f6fc5cb0f4f,org.apache.tika.parser,2,2,3069,0
4707526c2f2dc847c9031174f75f25ee94e54803,org.apache.tika.parser,11,94,2986,-83
6244bec006f1757753e29c543cf830104441f10d,org.apache.tika.parser,72,142,2916,-70
522f4f3ac2aa2f25be83242fcd5f778d8105615f,org.apache.tika.parser,36,41,2911,-5
cfe3527af83d582d12a43a6f42ff30bd2d15a379,org.apache.tika.parser,176,441,2646,-265
d3e678bf2c00961a33854ad3a0ecb0df7dd23b08,org.apache.tika.parser,23,29,2640,-6
6db2b1d5a1b556b6049ead3ee56ca01c46d0ba9c,org.apache.tika.parser,15,0,2655,15
c30bbcb8a5dfe9367777c00cf4b18d83020faefe,org.apache.tika.parser,34,158,2531,-124
7bdb1c8dea70014b3528736755868c526dfcf834,org.apache.tika.parser,64,49,2546,15
a03498cc893044e1f4c01adbbfee13881b02f2db,org.apache.tika.parser,7,20,2533,-13
d4bb41f7968cb40d39f66b2c0430dde3eef2e618,org.apache.tika.parser,39,40,2532,-1
ee2c3b90b736e3ccaeaf204a658e917b87d378df,org.apache.tika.parser,48,87,2493,-39
dcd89751d244a8b7e17d63e2088ede4eed94d8fb,org.apache.tika.parser,150,0,2643,150
6d37de9d208f1f7918df6f81a14a1d3b48a4d37f,org.apache.tika.parser,70,59,2654,11
62e58ea2e8ccd2ef1a968349408c990914efa6b6,org.apache.tika.parser,105,163,2596,-58
aceff84889da091010bcd893809427428a8b68a6,org.apache.tika.parser,241,430,2407,-189
c943f692982b70a43b4ddec37bc40e2a3de2d318,org.apache.tika.parser,461,81,2787,380
d064cb2f7ffd58893e05e327144816ddee6842da,org.apache.tika.parser,3,3,2787,0
70517c3648522b1fc3d1d3cb9f87e8f6e87753cb,org.apache.tika.parser,87,51,2823,36
a328f9c6ad676d51c34c7dd8584bac72438f99dd,org.apache.tika.parser,116,2,2937,114
b0a87ad5afe05da5087209062c229a53921ca3bf,org.apache.tika.parser,1,1,2937,0
1d2e41f3ba58b437f0ee72ca3a4c2ce782421519,org.apache.tika.parser,80,0,3017,80
703c4b0a74c831e4f763d697974284b9030b9576,org.apache.tika.parser,267,0,3284,267
800479155329ad38c8da37a8c04172bdbcec4a21,org.apache.tika.parser,1,3,3282,-2
e1da9a1fc19aa951fca916c850250ebb58eb8675,org.apache.tika.parser,0,1,3281,-1
580824e1088af50d5556e2a01d71311a42a74edc,org.apache.tika.parser,7,58,3230,-51
9ffdd5470b4b66c62b21dac13cb278acf2cad48b,org.apache.tika.parser,2,2,3230,0
bd68bd661d84ac33683916ae2d0b8651a51b11ca,org.apache.tika.parser,5,0,3235,5
a73e6cc60fa0f5ff496fc80d054f3cc981947557,org.apache.tika.parser,151,44,3342,107
2b09facfdc45660389072848fbe2190ed64d1a23,org.apache.tika.parser,5,5,3342,0
30d407243e1be2749002fabdebd79c700127d14a,org.apache.tika.parser,27,9,3360,18
4c8f0b8fff933890990c336e40ff5a419d08321c,org.apache.tika.parser,10,6,3364,4
4b126e887da913b559591eed21bebea8d48d2ae9,org.apache.tika.parser,5,2,3367,3
a01dcbe6552ab1a184544097575aa583ecbbe8cb,org.apache.tika.parser,26,33,3360,-7
5cbfe94b115934b04cea4954af97a4dbc1285393,org.apache.tika.parser,185,55,3490,130
c13e78df7c8cc562e1d1333f024ca9decadb7700,org.apache.tika.parser,9,9,3490,0
91913d37243cdab7a8a0c0de132b538ed6b0419e,org.apache.tika.parser,10,6,3494,4
2e18733f93866c5670c0af0d0b88262508882f8b,org.apache.tika.parser,11,9,3496,2
1f2b7168893b8e7e3cb20aaf7992e057d449dd79,org.apache.tika.parser,2,12,3486,-10
0da63b175221d330fdbbc11e7b1353f13c8c5d2a,org.apache.tika.parser,90,25,3551,65
314a53b9c953f672c4d63318d8357274d102220b,org.apache.tika.parser,16,0,3567,16
7f80b3f97d6e465955aaa0cad2b8635e973b727c,org.apache.tika.parser,0,8,3559,-8
5e97d465816ea70aa29b883487ccbd30622c3b26,org.apache.tika.parser,447,336,3670,111
88d8173fa7b9e5781412c92ec7abdd7a17b17330,org.apache.tika.parser,1,5,3666,-4
5030b1138c5626a761b6c03b90b761f4cdadc0a0,org.apache.tika.parser,14,4,3676,10
c4d64f89ed6966aebf7e19b301d9e01d23fca847,org.apache.tika.parser,7,2,3681,5
80866ff406ba6dd79c94def3703b18dfaf8128a6,org.apache.tika.parser,17,23,3675,-6
3a743efd63e737bfa0ef621923f6c9a2b7c1e50b,org.apache.tika.parser,124,41,3758,83
c370c52f87ec9dd63fc4deedecbefed45b5c9004,org.apache.tika.parser,120,91,3787,29
315b7e11db1f5002749ede87babab0e6a3e825ab,org.apache.tika.parser,40,6,3821,34
64e1e5180b49b78fa4559b3d88503e6d9825483c,org.apache.tika.parser,48,56,3813,-8
25150e0c66b5d2caf11370818a037180485dd8a7,org.apache.tika.parser,133,20,3926,113
7c83be9c00d203e22c8d042a802f719fa3297195,org.apache.tika.parser,133,0,4059,133
284f644f18f890d65cccc3f242bfefb21738b497,org.apache.tika.parser,288,0,4347,288
c9f08c28599ca08fa5aad06aed41f6da5de4737c,org.apache.tika.parser,147,0,4494,147
eb799732c835bfbdc183e6650d07231fe8b6d7af,org.apache.tika.parser,77,0,4571,77
28c13697bc5e882e984ef80683a4cafe47a0aecd,org.apache.tika.parser,17,10,4578,7
70ca6cee9ec87b9fa596ecba2ce0035c204a34a2,org.apache.tika.parser,40,13,4605,27
9b506beebeb582e643e24a842c3729e212dc5091,org.apache.tika.parser,4,3,4606,1
39ab46ae8e17fba317f27ab5b18167f69b2e6996,org.apache.tika.parser,2,0,4608,2
e12b04d4cbe43e6bdfc09cc917e44ff060498f08,org.apache.tika.parser,69,0,4677,69
d1ab05c8e4a9f192c0bcec5538af557659393e66,org.apache.tika.parser,106,0,4783,106
424c708540755608f592cadb2001fbe54ff28521,org.apache.tika.parser,2008,0,6791,2008
46f2fb81d9f05c35c61ee60b8f71da003c2574fe,org.apache.tika.parser,1526,0,8317,1526
e889dfad07ab4a8f8a1352dd5b0fd2b5ce18215a,org.apache.tika.parser,420,0,8737,420
19f04ad8bc32e088e7f0a328b151bb8d9fac397b,org.apache.tika.parser,0,3,8734,-3
2a405d3e28775ac789e2ab3a873cd302d332f722,org.apache.tika.parser,2,0,8736,2
c2b41c4af263ac4495154295881b277439bb3535,org.apache.tika.parser,16,0,8752,16
9ff3f2d96105cb64597a0a8d03e38a9b9aa23bb7,org.apache.tika.parser,315,0,9067,315
72b945efe82c46226291dba7112dda1a0dff6097,org.apache.tika.parser,104,108,9063,-4
e97ee495b5007a01b872d00ba747f0d612cab72a,org.apache.tika.parser,257,270,9050,-13
e0c59b5be8fc0301cc4130a2250b801fbf474b88,org.apache.tika.parser,46,0,9096,46
ce4095f389b6c42b48b70117392ed5ceaaf51142,org.apache.tika.parser,23,10,9109,13
d2df838867328f8ddcdd1299399eddbbd48c97c6,org.apache.tika.parser,0,1,9108,-1
048252939fddb381856c41f94ef1ce3f84057b3d,org.apache.tika.parser,36,12,9132,24
7d8686cb5e5ecf6d5a7268f8f3517b49440eddae,org.apache.tika.parser,17,138,9011,-121
ca427a103afb541408ebfced5d6e95000dbd626b,org.apache.tika.parser,283,0,9294,283
836c4b953552c4dd4359d45197b0f241824ba32c,org.apache.tika.parser,100,3,9391,97
9d5c3d8b58f886ad7f460e3f1fcc618c86ad6a6e,org.apache.tika.parser,24,1,9414,23
8dfa33c3d14561923e29da234700278911be0efc,org.apache.tika.parser,2,0,9416,2
3079789724edf724c492c3497630c3cbd5533ef5,org.apache.tika.parser,2033,2033,9416,0
27fdf2ce6987a55e7a5bab7b83deb203eab7621a,org.apache.tika.parser,250,11,9655,239
f969a260ce7f02f2e431dfa6dfbcd5ac0c7bebf8,org.apache.tika.parser,186,186,9655,0
3c15d9cad408753ab0faea4fe1fa1be1408fa7c2,org.apache.tika.parser,184,93,9746,91
e43a19e433b6085b91bf44f534dbf055db313026,org.apache.tika.parser,2,3,9745,-1
a9fb61439bf092318680fde1dad4e9d91aea96af,org.apache.tika.parser,0,13,9732,-13
e77e233f0e74edc6271a5dad2c8b1a7fe22925e2,org.apache.tika.parser,42,37,9737,5
8757a3561c632770595199a5930e02177bd172c1,org.apache.tika.parser,26,30,9733,-4
8b7a1d436b9fe8682b6f93872f7b8ff943b30c4a,org.apache.tika.parser,3,82,9654,-79
411c8806daf4812fd19709162a17f7b2a7b1ecd6,org.apache.tika.parser,20,0,9674,20
0fa61dcd25ed972580a3dd8d25b84f7a17273147,org.apache.tika.parser,4,0,9678,4
9758d20ddc6c45fd3ab40904a95324e304abf03e,org.apache.tika.parser,73,70,9681,3
922fb5fa6b4109c1ed4786d51aef02c6cd8b2b9a,org.apache.tika.parser,4,4,9681,0
e678e3213d0cb212b31a673a17d1fcf6cd6bc1d3,org.apache.tika.parser,19,0,9700,19
2ba3c7ecbcc8a7528f917f201301c9b326c8d0d4,org.apache.tika.parser,5,2,9703,3
2a77cf379166e9c2e5144d9cafa37a2146563a36,org.apache.tika.parser,10,11,9702,-1
d9575ae398a28c8145b44a0d0d351e9da92ad9f3,org.apache.tika.parser,51,9,9744,42
60c9b0e05868fb786180b3d7403537b2e66dce03,org.apache.tika.parser,14,0,9758,14
d016d322caa1e0928012287840bf40bf11293480,org.apache.tika.parser,1,2,9757,-1
896aaaf1f9f3b612ae7ca3e32a6ff52112342ae8,org.apache.tika.parser,29,1,9785,28
1c0109f83e030606388f2d6c300e138c2d881f9b,org.apache.tika.parser,9,2,9792,7
3040a361e4c921c35ed8b29fb3aad3f393537222,org.apache.tika.parser,42,13,9821,29
ea35b47f13948a9b67c7da5b983dc5ddf236c3f5,org.apache.tika.parser,15,16,9820,-1
e5bf6502b2661cbc6f6f49f63cc3c39c525dd37c,org.apache.tika.parser,144,3134,6830,-2990
206dc7a7d110f05562f25ba7e0ea7655a49362bd,org.apache.tika.parser,17,2,6845,15
3864f42f1025c023d8103db4c984c6ff723d4292,org.apache.tika.parser,1,1,6845,0
26a8225e5b2fc785fc69b1de9eeed807ffdad580,org.apache.tika.parser,20,12,6853,8
fa0955eacb284802417c4a0dbfca48d886c9eafa,org.apache.tika.parser,87,1,6939,86
2fa2699608047a7c723b2abce0f98fa3103544ec,org.apache.tika.parser,4,32,6911,-28
3efc2cfb5dc3aaad47051ab25f226f9bcdd83e14,org.apache.tika.parser,5,5,6911,0
a70b99fdfff5df924eb4bd706689ae215ecfc167,org.apache.tika.parser,65,91,6885,-26
87a45f986b228e897203a410a3edcde00b9b2d12,org.apache.tika.parser,17,18,6884,-1
15c83430df273aae65170d25ed95f4df62858de2,org.apache.tika.parser,28,8,6904,20
a09f5af5dd6e5b81bf7d3393851cc65f4855c619,org.apache.tika.parser,23,1,6926,22
00ae4b3c4ef6503086aac939ff023dc57c85137f,org.apache.tika.parser,20,3,6943,17
4abeb2d772fc33aebdcc06ca0dfadfb660055cc0,org.apache.tika.parser,10,1,6952,9
4307560767072216358f604fb9147f947c7dac85,org.apache.tika.parser,8,1,6959,7
3922b01361d5958a31c199e376e7a979a3a6d376,org.apache.tika.parser,270,25,7204,245
41ca17f4d54a2b679865add19c0aa91aba2d665e,org.apache.tika.parser,65,61,7208,4
d7853341f0aa1aae008aa34fd6bd5b8c8b9e96fe,org.apache.tika.parser,88,22,7274,66
0a60ac05ca164097cf5380fc6ae122be55197f35,org.apache.tika.parser,60,108,7226,-48
d634072d6bba29e5e19b571507dab7ee8a4e3000,org.apache.tika.parser,8,9,7225,-1
4c04a49781d86144a03d6a34841e5c3316daddcd,org.apache.tika.parser,15,12,7228,3
120c23875a61e1946125c37931b980964fe24d2a,org.apache.tika.parser,1,1,7228,0
4130936af0bb140355c65354c6e4a9894c19b3a5,org.apache.tika.parser,32,5,7255,27
9cfb4e1dad83854a9da85bcfc5aaae30b16ea73f,org.apache.tika.parser,12,17,7250,-5
6b9a82f8bfd59526ec03693e9e0262698a5ff165,org.apache.tika.parser,62,0,7312,62
26293c081dec22ba22f232f6d3d73c66a81e2ee9,org.apache.tika.parser,1,0,7313,1
a463b9fd2ac3046b7e669b3549385f962a2482f5,org.apache.tika.parser,1,1,7313,0
1e7a8745f159ecdb068b7088b0a435d9f9175854,org.apache.tika.parser,373,0,7686,373
d5090690acc7a353944f78c895cd7030cc34dce8,org.apache.tika.parser,3,3,7686,0
99c2dd5ea17081585bf559962e33366c4b2428d1,org.apache.tika.parser,16,4,7698,12
645850a6217897606c2c80b407022d629b16c152,org.apache.tika.parser,135,108,7725,27
b42b4b8e3e14c19e77e7fa18253294745c4cbde2,org.apache.tika.parser,1,40,7686,-39
732fadb93e3681760db196ed9d54bc8b7b6415e0,org.apache.tika.parser,145,16,7815,129
987ec1d66d8f7e0047e4a1ef5399e440a15877a2,org.apache.tika.parser,11,7,7819,4
03be219a6d7646d07c56b1cc98899d139cb62727,org.apache.tika.parser,2,2,7819,0
29c9a2728a08f37ab270a6a6c2a679a7228758bb,org.apache.tika.parser,77,54,7842,23
52ac68fb11a5dd2526b5c0a55d99877fc59f6086,org.apache.tika.parser,222,0,8064,222
e7524be4e4af1fb2be08b4ee1dd72c8bdac1793c,org.apache.tika.parser,4,0,8068,4
01bf6b52d0097ae5741308caf2cb811d997a3c59,org.apache.tika.parser,2,1,8069,1
e7f48bf7f5422105e8b14a02f6317242c8b6fadf,org.apache.tika.parser,57,1,8125,56
5ab52bf7eb4088ed949e212798909f845ddff4fc,org.apache.tika.parser,94,66,8153,28
7a3b5065db44818381ed22d8c26ca59f27cae410,org.apache.tika.parser,84,0,8237,84
bda2bb712d02d7f5968df60ea64bc89d47874a52,org.apache.tika.parser,35,2,8270,33
7a6089c0fd2f52119b5519ac30907875186e8815,org.apache.tika.parser,8,1,8277,7
6c2d6545d5f7ddf02ea6de75820c1f441569a2cb,org.apache.tika.parser,2,9,8270,-7
945871993c88dba87c6311f01e65bb1a61db12df,org.apache.tika.parser,2,1,8271,1
dd1ddf9282d464cf9e77667c217415404c26cd39,org.apache.tika.parser,60,9,8322,51
ad11aac0a56344521d33306b36f645f984173531,org.apache.tika.parser,185,186,8321,-1
b4405b7be7210fb3a0d08bff33a274c229744ea3,org.apache.tika.parser,14,9,8326,5
c1f35792274f05f0a5bad02af76bacda078df583,org.apache.tika.parser,68,7,8387,61
61d64d2d6525caaef14d0e4f96c33c77f18512ff,org.apache.tika.parser,18,2,8403,16
454589577f69a06ed6ba2ad157c2cca1ac55dd64,org.apache.tika.parser,50,3,8450,47
dbc2ef4fdd8bbf2dc0390f80267edfb9ad310af6,org.apache.tika.parser,12,7,8455,5
2354fe66ca0c7b6e16c8dc7b44bd73eaa975c057,org.apache.tika.parser,40,1,8494,39
8bd0ccb910e824ff64cf3d2f716ddea3c4295f24,org.apache.tika.parser,84,9,8569,75
2f0fa3b65a48bc4042491324cc546f9c32536c20,org.apache.tika.parser,21,0,8590,21
7ed838caf2579be3c2d450cad8b61a10cf36ef0e,org.apache.tika.parser,2,0,8592,2
5df8f87c4c865942a0c0990bc2c00a6d2ad0320d,org.apache.tika.parser,13,9,8596,4
16db6681ebfcbb622255f81f5006020af07c2d1e,org.apache.tika.parser,22,2,8616,20
43c83e71ac698aace39be16ddbabe25cb5219bd5,org.apache.tika.parser,296,0,8912,296
e3c68b44be524e9150774dff3f38559b04be0a2a,org.apache.tika.parser,15,12,8915,3
cacb6b8cddecd296f2923b90b8955e35588a909c,org.apache.tika.parser,3,0,8918,3
cee95ede1a153f8ad70c37d8d4b37bfb3d4df37b,org.apache.tika.parser,48,10,8956,38
3f271557f12a9de28274ca1a0805f01cba7c6043,org.apache.tika.parser,28,3,8981,25
0678c44ba5907840311ca3239d6aa232d55c1c49,org.apache.tika.parser,6,12,8975,-6
4c098501a80f9764638f154ee693e04ff515fcc3,org.apache.tika.parser,3,2,8976,1
7bb35308304dcd0a1ae51f1fceab4ffa8a83c4bf,org.apache.tika.parser,77,33,9020,44
cecaa12bfaeda1d6a9061c1b951a8d983d7be5a0,org.apache.tika.parser,18,2,9036,16
860278342476df7a0c1f3a148904a48c512abf25,org.apache.tika.parser,1238,227,10047,1011
fa286eefeb76322c2b6bd9d8de822a3f4fad6bbe,org.apache.tika.parser,219,0,10266,219
7c51e892ee4d6ca84841759e68fb8334bcc4a13b,org.apache.tika.parser,262,37,10491,225
0fa888e8d681eaea34de59d67bf4a15472bc859a,org.apache.tika.parser,52,16,10527,36
3ad79a6a21e0039fb451044b2b9e71f83f258311,org.apache.tika.parser,16,25,10518,-9
33171a5635184bfcf54afccd72b0dee0529f9f0a,org.apache.tika.parser,372,3,10887,369
090001dbcf35c5729167fec0947cff0988f08cfa,org.apache.tika.parser,65,26,10926,39
e64cad2d708e33347c8fa4a8b14a45554dd6b64a,org.apache.tika.parser,20,13,10933,7
1cad9b3fc6100a3b0f4a73b5ffac2dd23c680a48,org.apache.tika.parser,246,483,10696,-237
3caba576686bcd6fe9e4501cd13e589a81032e2e,org.apache.tika.parser,25,48,10673,-23
9a049b4cd60afdfa1eb37d58485758f8125b5340,org.apache.tika.parser,11,1,10683,10
55fb7c9e4c084e9f6ac92ddd56c36439ff97f879,org.apache.tika.parser,2,4,10681,-2
4400e3a866d2b4649eb23c251a7b887e977de167,org.apache.tika.parser,1,1,10681,0
9c7c2c26deca3e473faedddff667249c11635d80,org.apache.tika.parser,27,1,10707,26
29ab691396ca430688876217a12ed039b5409a07,org.apache.tika.parser,0,22,10685,-22
bbd3cd3e96c1c09bba0e6e8b3974cb67cff251cb,org.apache.tika.parser,30,2,10713,28
14a229e5814b0148ba0b8d08f0cc71708a861c88,org.apache.tika.parser,180,0,10893,180
550a2dc1a50ad9f0d5d358b7f520e20292b4ce5c,org.apache.tika.parser,117,1,11009,116
6464286bad883200d991709041d3b981198606e9,org.apache.tika.parser,174,1,11182,173
9f10da2479473d7a16e333d727771376af5851df,org.apache.tika.parser,44,7,11219,37
baafe0e6a00e53fa975f696ca0adecb2027dd186,org.apache.tika.parser,3,8,11214,-5
af2aabb03cd876b9eaf04cf0496290a979b70e19,org.apache.tika.parser,24,14,11224,10
6f758f813c435105ebe289478fd01addd227c38b,org.apache.tika.parser,7,5,11226,2
64ed1992807eb7af1db53c5e68660641cc8de3da,org.apache.tika.parser,644,100,11770,544
86735b246d2350d6a19c39b83b7189c18007245a,org.apache.tika.parser,513,1,12282,512
67748e39dd351d4fe37febbd7ea3eabb244970d2,org.apache.tika.parser,39,9,12312,30
890bcb5b97a4a9b411bf2a5b4178d6abd2e4854e,org.apache.tika.parser,8,1,12319,7
f1f45a749ebb78e7f47f98d4201bd338aa3a90a5,org.apache.tika.parser,249,0,12568,249
d4dd4009960026c721529233ae2e28c283cebe38,org.apache.tika.parser,51,53,12566,-2
8451402e1a635714d82cea42d8696ec2a5235cbc,org.apache.tika.parser,62,8,12620,54
dd6330f7dfa0f836918306ee718e48f9c4418dbe,org.apache.tika.parser,191,128,12683,63
eb7aed162eca710daf139cf57c3d0746fe11b741,org.apache.tika.parser,374,13,13044,361
a2d3c00607edacc3bc8e3ee801d972be2542c2c4,org.apache.tika.parser,33,89,12988,-56
a4a6c027b6363031eed6f8a7f44cb9635ea01707,org.apache.tika.parser,6,5,12989,1
d533a2d5b72a643b973b533b8b0ea7c60ede69c4,org.apache.tika.parser,54,7,13036,47
d0f703f4e067c3cd07a3e959e7f143c8ff4d7e27,org.apache.tika.parser,5,0,13041,5
2846c74e6508a40a6f0ec29fce46b5fef7787265,org.apache.tika.parser,42,1,13082,41
72cc380f6a6419ef20cd591186650607884e58ec,org.apache.tika.parser,40,3,13119,37
414c592f8e1bb45a6a9ef223670044a1a2a34dff,org.apache.tika.parser,5,15,13109,-10
157fcc98886ec8b5068b663ff7ab4a3ca03c5749,org.apache.tika.parser,1,1,13109,0
ed8497d10df01374ddc63ec6cc988c191a881b95,org.apache.tika.parser,26,4,13131,22
c02b1529c8011a41892975f2bc0f3cace4a11016,org.apache.tika.parser,126,4,13253,122
189557f007627cfa3640400693f79a65b9ffde07,org.apache.tika.parser,196,37,13412,159
59d2e57a54df73a9da3af3cef7585d2b79e9b7d9,org.apache.tika.parser,93,1,13504,92
423eabd3ba8adaa455934d349f7523a22a2291d4,org.apache.tika.parser,11,1,13514,10
61751d2e4de9a62addfd25a3e51929838ff6dde6,org.apache.tika.parser,98,0,13612,98
ccf1216521eb6fcc00918254db7d310c3405f01a,org.apache.tika.parser,29,1,13640,28
2f780351ee73a089c605b93383b82908c040d74e,org.apache.tika.parser,5,0,13645,5
3cebb673fef211cfbde44f2dfdda47bb20f98ee2,org.apache.tika.parser,10,5,13650,5
007f2d783a13ba309f1c41dfb793060a2c478060,org.apache.tika.parser,115,149,13616,-34
76afce1f5f8fa9e638304b838bdea8b5816b3abf,org.apache.tika.parser,0,6,13610,-6
035dab3ff15c964c0bf04652b88e2aacde92eb44,org.apache.tika.parser,0,59,13551,-59
dce07df9ea5f1be024e20cf809ffde6425b6368c,org.apache.tika.parser,0,3,13548,-3
66882d31bd1bd949438c0772f10ac2ce3a9a8cf3,org.apache.tika.parser,2,1,13549,1
a87d3e640647d056542b5970c8d21701580b4913,org.apache.tika.parser,9,10,13548,-1
ca465e38fa2fe14cb97fa75a4c0fbe4f2d39dd63,org.apache.tika.parser,6,21,13533,-15
9ba3b5852ece3f19bcc3925d871a327b3501bbf3,org.apache.tika.parser,7,9,13531,-2
74a432d3bb6f1c746dbeef52892b8da3e0872c1a,org.apache.tika.parser,128,0,13659,128
4658fd738e12bb380b888af906a077da7af1e32d,org.apache.tika.parser,10,4,13665,6
11bbc01edef720419f3b68e0487ef057cf13a387,org.apache.tika.parser,8,1,13672,7
85aa4d24d9b5e3799301ce93dcb9fe54207415f8,org.apache.tika.parser,178,0,13850,178
66077e1cfd1d9b336b1545cac45cd962be0da359,org.apache.tika.parser,112,73,13889,39
3ab109690ff45e026311ca81af783300cab36970,org.apache.tika.parser,50,7,13932,43
871bea94785cdd76ffd2e3f6812912b987489c9c,org.apache.tika.parser,46,8,13970,38
1b3de639ac587d09cacde8653947146410d49d84,org.apache.tika.parser,53,3,14020,50
8fa36e177948e6e7c4f5558bab5c3e1312911980,org.apache.tika.parser,1,0,14021,1
c730e0ddfd1568e268d9dc45132108c8226855e1,org.apache.tika.parser,1,1,14021,0
458753cfdc2d8f9941ea84a94267b84a323f117f,org.apache.tika.parser,2,1,14022,1
621950e130c594e709d02a1e742d094a96496a9d,org.apache.tika.parser,6,0,14028,6
f8a3d0bbc4ebceef2f91111f1dd7da1c2017c970,org.apache.tika.parser,11,3,14036,8
486281b69d4d0f83ec4c35b85514b18b90a17eb8,org.apache.tika.parser,50,10,14076,40
a1c050381e3cd2fff0ee9144f2d867d0491a1cdc,org.apache.tika.parser,5,0,14081,5
31345be7c8cd6e347d0f7aeab12d99ed44187145,org.apache.tika.parser,108,37,14152,71
163d93c4e1e78a27b5dcd9502c2a4757fbd53b7d,org.apache.tika.parser,87,1,14238,86
52664ffad6df20f8c864f3f22ca5ca22759fddc9,org.apache.tika.parser,17,15,14240,2
e347b9887b6f02c00082c393b5a80d2126539995,org.apache.tika.parser,54,44,14250,10
fed8c465cd4b6b6fd4158b284b317806064f0a33,org.apache.tika.parser,50,1,14299,49
4f6a589842f4648f23a0d9e4bac5283893cac9da,org.apache.tika.parser,44,18,14325,26
ed7a1d1bda0d981359261c20e8617a73d7dc482b,org.apache.tika.parser,129,39,14415,90
31452f9fdf15ef93f05cacf2a4f0bad530b89714,org.apache.tika.parser,7,4,14418,3
c1f7fd7e5de2c31eddf9b0df086d214ea9adf08c,org.apache.tika.parser,158,158,14418,0
bc3fd0722e3f07ba18c54af7108f9f82cd9ea0d9,org.apache.tika.parser,530,530,14418,0
9a2bef7e4d893d7bbde4a267bf3eca6da40ecab2,org.apache.tika.parser,35,94,14359,-59
729bca59b0b81ddcb33054938037a31495bb4edd,org.apache.tika.parser,161,19,14501,142
806ccd1b7fda712753f855d344b20b4edad24ffe,org.apache.tika.parser,17,2,14516,15
d98bc51e51d8a267e9420bba3675b122a6b1a16f,org.apache.tika.parser,86,0,14602,86
a20e0c19a5e1c0235fe0530742edf7df824ae5dc,org.apache.tika.parser,86,86,14602,0
0c40fd5ca20c7139069bd5da5e9f87aec372317e,org.apache.tika.parser,8,3,14607,5
274acac0c57b8d0b7fa904524ff9723e688a86a3,org.apache.tika.parser,10,26,14591,-16
3864c2ef1dd3d300b67f46cdc1e7df9974a08d08,org.apache.tika.parser,229,17,14803,212
af99a319fb9527065a24b7b1b5648368ac33c4af,org.apache.tika.parser,98,0,14901,98
01a1067539f3450475a95be26c4be958a6a0d58c,org.apache.tika.parser,52,67,14886,-15
d0cd679a119eb1ebcea1bce1f0d0ce9ea39e72bd,org.apache.tika.parser,2,2,14886,0
0abbfee21acacabadd74211921ed7c047201f68a,org.apache.tika.parser,35,3,14918,32
6d7804fd8edc214c5c2482816f431c935b7f0b8e,org.apache.tika.parser,163,32,15049,131
d4e7bfdf502e80a704ad4842e74596675f40bab3,org.apache.tika.parser,8,0,15057,8
1a564ef51767b8d8117bb9c4f58ad765214cc50b,org.apache.tika.parser,3,3,15057,0
d60651e489947e4a57eac775928e4b82d77fbd6d,org.apache.tika.parser,44,7,15094,37
b3c8dc86e5e5a9a1035a4de730ded76fddd01369,org.apache.tika.parser,196,0,15290,196
7153f6b06999ffb448c9d1f04a76ed494c390c29,org.apache.tika.parser,1,1,15290,0
92188c483c0b1c5d63faea26e24c44985558669f,org.apache.tika.parser,6,44,15252,-38
195f1d6e61792bbd2493446641ec0045f74d0e14,org.apache.tika.parser,7,0,15259,7
4b5ec9ab4921771d5cddaa5be2e198486b9d8bf0,org.apache.tika.parser,2,2,15259,0
d4a401460f56870c5085d87ec4f4856b6e6aacf3,org.apache.tika.parser,2,1,15260,1
4d5eb3851a791173bfbe1aadaf630923fe6c5837,org.apache.tika.parser,8,0,15268,8
7cb1b4abb762f066bb129b815eef8107a141afa6,org.apache.tika.parser,2,3,15267,-1
31e60d997c92843067a0de72d43cf70def0e38ea,org.apache.tika.parser,735,275,15727,460
cfe575a8b87e61b2b19ba73d50807eb896d24651,org.apache.tika.parser,197,0,15924,197
15851353b213a8edf6696f529cf3d8609eeec182,org.apache.tika.parser,10,1,15933,9
3dd12110dad0e5a71555d4e4a0e5a6cd609b0fb7,org.apache.tika.parser,90,13,16010,77
8e58142f50588e11c75529c0489a04d9cb167e1e,org.apache.tika.parser,30,2,16038,28
1573be6da5c9d6463d9fb6c697708e755c8621f4,org.apache.tika.parser,243,29,16252,214
adf462095e270db221a2154ee2f56dadfd1e34c7,org.apache.tika.parser,344,0,16596,344
9e9a9d9496304d07081d77c3d9261fb5965e0521,org.apache.tika.parser,10,6,16600,4
a7d6cf4fac56cb2623393c8734560d1af5be970a,org.apache.tika.parser,157,156,16601,1
0349400bf3374adb998bc0177ba072da2503c0a9,org.apache.tika.parser,23,1,16623,22
60590444d9150deb50aad3fe0d77fc3f921dbe60,org.apache.tika.parser,65,22,16666,43
edd122dde40de1eb77e8da15039a3aaf6792610e,org.apache.tika.parser,10,0,16676,10
12622b402e2343b35b7ee3d09bc506660583f985,org.apache.tika.parser,3,37,16642,-34
0fa372711329b8765545b9f28f1112d9e955352e,org.apache.tika.parser,10,67,16585,-57
5451e28bc4506703205741b2163d785aa4e27826,org.apache.tika.parser,31,2,16614,29
26800770bde7df358548d8d2e52b7bd0d073e881,org.apache.tika.parser,32,7,16639,25
1812a8612fff219adc7c2d0daada8aa652104024,org.apache.tika.parser,0,3,16636,-3
3e795106be703e44c0400c2617d340705748ef9e,org.apache.tika.parser,14,6,16644,8
164302f56b53a1a8f4169a88d30980a8c2897f47,org.apache.tika.parser,0,1,16643,-1
81336229e106373e3eaa190f61c8ac2667c85fe9,org.apache.tika.parser,3,2,16644,1
cd4dff4df0699bcaebf4fc7f3e59ef77b9a9ba47,org.apache.tika.parser,309,28,16925,281
7b15af58944b6e67a9e4ac1a3e2a22ec59388fd0,org.apache.tika.parser,31,1,16955,30
6fd7bb8c982a554b4f4260d77578773a8d51bf89,org.apache.tika.parser,5,10,16950,-5
981a1234f3cf05f75934f6b1f9043b381119f7b5,org.apache.tika.parser,0,1,16949,-1
c139c2dde6709dba6eaa6b6c05e0ac9a43742a43,org.apache.tika.parser,37,16,16970,21
ba5671c3f668decc79809d6ed8c8880219ab0ddc,org.apache.tika.parser,2,2,16970,0
2bf987b00c7d0b4d772b3502842ac3bb673198e6,org.apache.tika.parser,12,5,16977,7
4fca14426d641bb81e49ba5ec5c9534dc8375e43,org.apache.tika.parser,1,1,16977,0
2129a0f906deee6fb05563da91d8642a72ac824b,org.apache.tika.parser,41,36,16982,5
e15598f83c404abb840bfe5cf285a436d2c3df3f,org.apache.tika.parser,15,7,16990,8
d7601cc4516c3e2e9d00e882ba3bbf9c8f16ef8d,org.apache.tika.parser,10,4,16996,6
8b87a3848fc28ffaf536c5d3e5954239959cac2f,org.apache.tika.parser,34,6,17024,28
cd45bd25057d9718afac37c69e6b4ab5b1b91a7b,org.apache.tika.parser,20,1,17043,19
ca6b5ca5614867a682b966fdfa35a6f7b48c1591,org.apache.tika.parser,223,24,17242,199
f45b0f863e0e0695840a000af9cffd0236d90b58,org.apache.tika.parser,12,5,17249,7
8eb3b880614c0eb5b4ca771ef9b92783b7cf3033,org.apache.tika.parser,5,4,17250,1
0c0cbf72286214d6c306a41ca218cdc2369d73d7,org.apache.tika.parser,31,5,17276,26
683ac820ebcdbfdc9cd1b4c8b0fe33fafdd93ee3,org.apache.tika.parser,11,2,17285,9
dca2ee6571555fcdae8f5e8ab04a1b662c9684bc,org.apache.tika.parser,207,11,17481,196
58f7914e79c25bc623b7b0ab14562fd6e3a6aa93,org.apache.tika.parser,214,36,17659,178
3b61cea5aba160f9289db7d913aec2c00c3b7a6e,org.apache.tika.parser,116,343,17432,-227
2821b706cc12838fce1730d8299107b3840b10be,org.apache.tika.parser,582,2,18012,580
20f881f4611cfdca3a8eade6d3ffed2662d4808d,org.apache.tika.parser,39,0,18051,39
92b0f12eabcbb6f82f03a7f5635478b3fa790391,org.apache.tika.parser,171,8,18214,163
75c5bcf38ae0bb06047ec364db63b12f3bbae486,org.apache.tika.parser,183,0,18397,183
b6d67d32c1e43de488673d1925e0b6319588e4f9,org.apache.tika.parser,4,0,18401,4
cfb1779a55f3e16fea83f154501602197231f1e5,org.apache.tika.parser,4,1,18404,3
e67859b115adbfb7d01fce706d1debcfde0bc19a,org.apache.tika.parser,81,19,18466,62
a5df8777ca65f6f40545d0c02455b2443c6955c0,org.apache.tika.parser,2,2,18466,0
3ab6160ca74fd1d6bb2e5de3ddb43d48b4ebef9b,org.apache.tika.parser,5,1,18470,4
87fd9affb574d62ed26d669adaa3d7cf37e124fb,org.apache.tika.parser,149,104,18515,45
6af91c661f3dbebcb599b67635fe858a26576ee0,org.apache.tika.parser,8,1,18522,7
8ef4561642c3b0b4173480b82708e192ac06d2a3,org.apache.tika.parser,1,1,18522,0
1835ad392b2ed8ce0673483833fb28f3f8bdc855,org.apache.tika.parser,7,4,18525,3
8c5858702a84042a76ade840d8b94a9717b51bc5,org.apache.tika.parser,210,223,18512,-13
1fcb10afd65a0a007beb631a3ac5f1f6b8027d35,org.apache.tika.parser,14,1,18525,13
ddceb68bdabc6fb732ecf2182dcb589237277a58,org.apache.tika.parser,3,5,18523,-2
c69ff98eb0bd35d207ae0c281834d174551749de,org.apache.tika.parser,49,3,18569,46
77c7847b54d396de91f281f4c58ff69d67ee9910,org.apache.tika.parser,6,2,18573,4
c77287289407b971e8e1811fd1e976e6f59093ad,org.apache.tika.parser,39,19,18593,20
35fc876bb59982829fc6d550ab24417ecda4a74b,org.apache.tika.parser,94,11,18676,83
c2f7fe03d7bbaf0ce42f9c0ea08c0871f39a9c24,org.apache.tika.parser,20,23,18673,-3
329ebc5b5f3d7813fc50e58c9679db1b35e69f4f,org.apache.tika.parser,33,37,18669,-4
3b10c70971dc07720de331c0347810969ff2ff6f,org.apache.tika.parser,90,122,18637,-32
355bfe219e81ee286becae892c3835b7ef95c4f6,org.apache.tika.parser,108,0,18745,108
3f618f6735a27a1d01aca4dada75fde62c66f014,org.apache.tika.parser,12,9,18748,3
4d89ea2c6349fe07b5dfc1134fa5cd4960a33710,org.apache.tika.parser,26,6,18768,20
deeff20a3d6702e5e10a931de8186168f0d521ee,org.apache.tika.parser,11,5,18774,6
fb732d60934a4132131c89f668b21568799edee5,org.apache.tika.parser,190,12,18952,178
e152e264aab1cd0dfa9d431c4ebee2affd5e8dd2,org.apache.tika.parser,6990,0,25942,6990
ab666f28d2c8e713e3d00a8bf3770edde519c461,org.apache.tika.parser,5513,0,31455,5513
cbba597edbc6a0bf9efdcb9798c5359c439a4e4e,org.apache.tika.parser,312,0,31767,312
82a4e4911b04ca03294a5c5ec268a36bbe70745b,org.apache.tika.parser,0,6990,24777,-6990
8c6010b708439a8ea45669a40060dbfd862ebe7f,org.apache.tika.parser,1238,0,26015,1238
69f49a9733914b3a790fad1c23d4456d63343a53,org.apache.tika.parser,5067,5027,26055,40
42d7de94b51542e027e4d124e22d80e06a11e939,org.apache.tika.parser,857,809,26103,48
f2e35d02238b5a0839027d4405f62fe134db7678,org.apache.tika.parser,17,0,26120,17
3dee4344a37ed7938201d485c20f7252ed23dc25,org.apache.tika.parser,52,0,26172,52
cf8cb44b4e4e8de21b65d05f8c73fa8b0e6af477,org.apache.tika.parser,208,220,26160,-12
6a62fe06b4d5b54830a43235ff247aeb63b6811e,org.apache.tika.parser,9,7,26162,2
608a60886d2c3236af6d333d44c390f1ead68d17,org.apache.tika.parser,44,38,26168,6
31ce68f698019a9051011faa6bbb47b082ed210a,org.apache.tika.parser,23,6,26185,17
f5a943897834e52a26f6484e62c33b6f490084f1,org.apache.tika.parser,272,0,26457,272
afb429c72b42d4e4fbdcc732b34e27fc0068fd45,org.apache.tika.parser,2,1,26458,1
5ad279868b39d4cf5cf2e6bc2ebb9c0bfc154ded,org.apache.tika.parser,16,0,26474,16
96f592ae9d22847dda5023f6456eeab73c09a2b4,org.apache.tika.parser,102,3,26573,99
fc138458ed51df0bb3e3345611de68eb984ff3c5,org.apache.tika.parser,19,0,26592,19
f7607ecb57cedee963eb5361efd1e55d5b2ea43f,org.apache.tika.parser,4,11,26585,-7
ca890e427a1623b0e100ebe45a49edaacf17db39,org.apache.tika.parser,108,0,26693,108
f5f1ef1195f9d44e39b1713d58cad3eb83b351fb,org.apache.tika.parser,13,0,26706,13
61c1637aaa8b8a454be5e0f21b44ec92d81c47ad,org.apache.tika.parser,1,1,26706,0
b303c6ac4dffe30b0c30039da4c955a761fa1c6a,org.apache.tika.parser,5,0,26711,5
2af24f423ffd826ecf529c2f9c60bc59be2c2b47,org.apache.tika.parser,6,0,26717,6
62abba6178d70f4255e0e16da9eb456cc150615b,org.apache.tika.parser,5,0,26722,5
1be0e522934754f4918dccb700bfc8930906c579,org.apache.tika.parser,66,75,26713,-9
3c3e6d1fa65db1b5d8c01bb42a5da85bbde67bcc,org.apache.tika.parser,0,11,26702,-11
ea2cfb0e2c2e828fa917058f547bc44bae4e8a31,org.apache.tika.parser,8,1,26709,7
d64fb550f400597267382abd95e5bd7c3805fb5b,org.apache.tika.parser,19,1,26727,18
728a218d7ea8c0f478cdbd1235e675ed7905314a,org.apache.tika.parser,3,3,26727,0
33595666efff7b475e461af98446e682a5724ca5,org.apache.tika.parser,39,25,26741,14
8ef85fce930576a40daa400cc1419da4debcb654,org.apache.tika.parser,8,0,26749,8
3e832b08f0b7b2f528af65bd2c10b414e21ded07,org.apache.tika.parser,79,203,26625,-124
6bc0e0554fff5cb287caa56a10eecea60bf840bf,org.apache.tika.parser,27,25,26627,2
6bd95ee7eec85356b90d407084c4e45eec97e8df,org.apache.tika.parser,22,36,26613,-14
ddf56cee81e96faaab73d5d2ae70262692431fc5,org.apache.tika.parser,15,12,26616,3
9d5cf328f700e655a38cdf547fc86a273b854b78,org.apache.tika.parser,67,15,26668,52
07f6f6341cc11520eb1de18a4b9b712ac514f28d,org.apache.tika.parser,91,3,26756,88
4c5599b6694a31e8ce84a1a0d88100827d98490e,org.apache.tika.parser,3,4,26755,-1
5c22595f655362f983e73aca4fb79149f37a17ec,org.apache.tika.parser,1323,409,27669,914
d30f1ff21918a7696f4e32cceafbec8097a61a4f,org.apache.tika.parser,45,46,27668,-1
fdb902bcea910756c9f498b0db9bf3a1870cb2f2,org.apache.tika.parser,12,0,27680,12
c4c8b2247dd90e0f5ed3b9eac6da471e013989a8,org.apache.tika.parser,44,0,27724,44
de3538527dc7658735a7544c9f904007bc180021,org.apache.tika.parser,0,0,27724,0
8089184558f4fb9e84fe76e5895be2d5a5b7d726,org.apache.tika.parser,7082,7082,27724,0
ebb033881ffe2605d2c2d9d3fa619aec2f90e7ff,org.apache.tika.parser,48,23,27749,25
111fcd5384f2265c220d8578a2d6bfb552fffa48,org.apache.tika.parser,2,1,27750,1
ec9d7d201f0fb580a32b599a6340a220063ca82c,org.apache.tika.parser,8,9,27749,-1
1109b5a9bdeec12c9d220017d46b7bf8f9c3bf76,org.apache.tika.parser,3,10,27742,-7
b62ce33cb695a7625e9454eb4cd2dd36051d09c5,org.apache.tika.parser,4,1,27745,3
683c9a87cb746e8aa3e260495147999bcd61175c,org.apache.tika.parser,35,13,27767,22
cbd8a3191a02af85c34da9f0bf68184a2ddb66b3,org.apache.tika.parser,6,6,27767,0
c80eee31e10872648a1d23fefc8e13bb3b0e65a4,org.apache.tika.parser,62,10,27819,52
0406ad0c64d131c50d92b14f2112692172393304,org.apache.tika.parser,2,1,27820,1
add1168c9f95961f6c986356c400a2e6a11e5f27,org.apache.tika.parser,1,2,27819,-1
0396c4fe2a36f3088f9def8b0216be477fc33c59,org.apache.tika.parser,18,0,27837,18
dc2b9a1fad73867e1499fbf03695eec051c536f7,org.apache.tika.parser,28,23,27842,5
4e0b3e6cef33706b8e2eb510e4a1a04433b5938c,org.apache.tika.parser,77,1,27918,76
da8cc2a822211064e5fda5188810bf16c48d1da1,org.apache.tika.parser,4,4,27918,0
609cfe70bd396dc311c694161a59c1ac7076735c,org.apache.tika.parser,28,20,27926,8
8f3097fe00c60dbb9801e3729557fb39a01347c0,org.apache.tika.parser,3,1,27928,2
b5d50652678198c1fcf1e7e1aa7eb146451b1459,org.apache.tika.parser,23,32,27919,-9
aea844ec10793bb440b0b1121cf7dba42bc13b16,org.apache.tika.parser,5,6,27918,-1
01bbb05f78a608649dee8614cdb9be7d3d84e496,org.apache.tika.parser,233,1,28150,232
bec14dbfad2deafbb29f1b21f7c104b72eaf450c,org.apache.tika.parser,18,18,28150,0
a5cc41a492f7b74d3a4612da9c6e8cac1efe1732,org.apache.tika.parser,7,3,28154,4
c256022ce85a05be039e81f152fe895cb4f38b3a,org.apache.tika.parser,13,1,28166,12
02ec12f6b89d247905e63df050349c80ba70735d,org.apache.tika.parser,2,1,28167,1
1aaac7faa4c43a53231492df115abce3301a5922,org.apache.tika.parser,1,1,28167,0
30a22bef72b87a50fe3e3525208b322feeb62e41,org.apache.tika.parser,2,2,28167,0
9769f860a20af595c85ba751c4b6652a8690a2e6,org.apache.tika.parser,86,6,28247,80
94356cb82bdefc805b8d09bd00057ed8e260199e,org.apache.tika.parser,66,5,28308,61
25f7a4d5dac3b7d4bebaed41ef43bf37d1e86814,org.apache.tika.parser,33,264,28077,-231
3083e916b9a58aabca69a4cb7462415d4a7468e4,org.apache.tika.parser,120,17,28180,103
693d3c6f9a979b2f95d16dc1e389db994010f7fb,org.apache.tika.parser,35,7,28208,28
2e976ca42e1beae14a706e9461f59e078f4d3704,org.apache.tika.parser,104,1,28311,103
1ef02dba54362fa2fec5798c7aa79d71500a4f96,org.apache.tika.parser,3,0,28314,3
e910698ed42888d0c30dde88f2ceac7b2f841b98,org.apache.tika.parser,2,2,28314,0
6673d51674946be52905ad5b448ba2051092fe19,org.apache.tika.parser,174,143,28345,31
1d7259dcfc9395ef6bcaa0a7465dca3be49d6170,org.apache.tika.parser,5,1,28349,4
7f970efcd233a100f1cf8b50890c042ab6a8f30d,org.apache.tika.parser,63,4,28408,59
2c3dbde39c16161dafc4b5cc03db4e259bf7fb7f,org.apache.tika.parser,10,0,28418,10
ad78ecd3a85fcfc61b22cb045b3881cc9c170b13,org.apache.tika.parser,67,28,28457,39
7b8096174908f1bc0e388c88b0e25566eee2b8e8,org.apache.tika.parser,65,7,28515,58
c631563b6e2d3f3754ebdb365a63be86fac1109a,org.apache.tika.parser,192,191,28516,1
6ef64ddbeff4b23ee25e3d3f51f8a07c49d37c2b,org.apache.tika.parser,22,8,28530,14
374538b413fffbc254dca221e7a56021421e8871,org.apache.tika.parser,5,1,28534,4
7e2326a8050352a38c2d278174877211d1049436,org.apache.tika.parser,10,3,28541,7
f8e572b5a18699ff25f1bf21744662877a3d362f,org.apache.tika.parser,86,0,28627,86
0ee593533742bbb6feda9c4f0591163cf22bef20,org.apache.tika.parser,32,32,28627,0
915be4f4fb999a79ea1f3f90b3a2637ea086ae26,org.apache.tika.parser,71,4,28694,67
e2720e4736b830873d0abce69f3bd3e3798e527a,org.apache.tika.parser,7,5,28696,2
b93fc6f1b3e16e8f76dadb4d7a94a782879fe3ef,org.apache.tika.parser,18,3,28711,15
bc075703823e7250a7ad7db93ef58712133920f2,org.apache.tika.parser,34,0,28745,34
5a1ebc75ec867a1d7d204239054e27198b88e2ce,org.apache.tika.parser,47,4,28788,43
554605b284b0c4ac32b8cdda512700d780915a8d,org.apache.tika.parser,33,1,28820,32
3bdf69a7d2e119aa722a097d81a99fd63d76be78,org.apache.tika.parser,102,28,28894,74
e303705a4beab60fe4dad27f29621939fe2f0d0a,org.apache.tika.parser,151,144,28901,7
fa076c5ddf7d6685fb491a6cfe531c4eeb91f542,org.apache.tika.parser,1,1,28901,0
0f54339112fdc6c887d2f9e05d0826b1c7462873,org.apache.tika.parser,123,37,28987,86
f28f380415ca1aecc70dd8b9c57a2d18a8176d55,org.apache.tika.parser,32,25,28994,7
80d36ebce4db6b3a15d853b12646c9db40b6cd42,org.apache.tika.parser,35,2,29027,33
a2555c65cf806b7ff47a33c579b33ff7aaf8f3ae,org.apache.tika.parser,200,0,29227,200
c657ecd444505bd924bcf6bd2ed3c4be04f85692,org.apache.tika.parser,107,7,29327,100
45ac50a852749a90c3da4150f1666251f5f0cf74,org.apache.tika.parser,14,15,29326,-1
c95bbb37774c3b09bbac0746e6116ee139cc42c8,org.apache.tika.parser,30,7,29349,23
7c43bff1a585550a2e1854e5de05c37c56ec7cde,org.apache.tika.parser,5,0,29354,5
c877ecc800c4085e4f13bd36c7bd3840c3d662e2,org.apache.tika.parser,70,2,29422,68
84e8fc3625d50e956f3295a846c4b21b99070a19,org.apache.tika.parser,16,2,29436,14
85ae815a0f9a15ffd0a3f3870768630e53e5dd1b,org.apache.tika.parser,25,9,29452,16
fa10b69d9a0d19894d65d15dfb92d0087af13e56,org.apache.tika.parser,395,0,29847,395
fe9897c60c7f8326200b2dbe17b48acc890913b8,org.apache.tika.parser,6,11,29842,-5
24bc3dc6f752d342a2d994da24545d4f9698ce90,org.apache.tika.parser,45,21,29866,24
a170fbe96fae15406d34d84b42f804ad828df745,org.apache.tika.parser,93,4,29955,89
5498c0eeea7d2a5d6d314bcddc7d307830e97c27,org.apache.tika.parser,6,0,29961,6
53ef1b992d779676987d737e634b66f45d58310b,org.apache.tika.parser,2,0,29963,2
6454566da5e6c3ae9fe989145277d3b657f8de65,org.apache.tika.parser,1,1,29963,0
5e104ccf22ca2034de46854d5a84392b5798d090,org.apache.tika.parser,72,9,30026,63
4cf76141d00d705324dceeec7c6dfe1c1a2c75ce,org.apache.tika.parser,3,3,30026,0
59cab5fc06a07387c8e71c3e2dfd0f7a887e4180,org.apache.tika.parser,25,3,30048,22
84a2a2757c2b8080b450d5341fb20a321a85923e,org.apache.tika.parser,9,0,30057,9
fbd2d6db793746fbb5f605731157b5181dd6ee9d,org.apache.tika.parser,2,2,30057,0
6a8b23bf65adba79c60e8d1b0e21e2d6fdef59fd,org.apache.tika.parser,30,0,30087,30
b11403daaddbbfd5385180a611b84ed5d131772e,org.apache.tika.parser,19,11,30095,8
16c92d0345873591dab9f9fad199d83fe11ce7b1,org.apache.tika.parser,51,28,30118,23
d8e91b6beb45376a351305c53698ccca98177462,org.apache.tika.parser,32,2,30148,30
f4332420e55c093463bf0b84a8256c412f4cc03b,org.apache.tika.parser,0,8,30140,-8
07e105b4a6dec3ac528b729a3b7dd458d49f73ab,org.apache.tika.parser,51,60,30131,-9
35539abaad27119d6a5a51728b2a93a6e981d38b,org.apache.tika.parser,33,0,30164,33
27fbb0a2303433efb077ec449a591114c264e3c1,org.apache.tika.parser,53,12,30205,41
aa901df66c086303085ab5fbc5f1febf75ce031c,org.apache.tika.parser,174,11,30368,163
c98a42173ca64ec77b7e19eac9ad9cf5cf71c776,org.apache.tika.parser,76,3,30441,73
7ef354893172ac0a49f929e950e72154d4793b44,org.apache.tika.parser,2,9,30434,-7
de7092125649cd61840e27b1f70d68cfab910d89,org.apache.tika.parser,821,0,31255,821
f0107444a5f038ba6f087e517a8d87530122a0a9,org.apache.tika.parser,12,15,31252,-3
9543dfafc94be216a24897a08ea002396927971a,org.apache.tika.parser,8,14,31246,-6
0204adc0f4d3ff6e10f94a82bad442625e81a7fb,org.apache.tika.parser,0,5,31241,-5
b90d72d36534d5b175b86b8584afd4f236f47696,org.apache.tika.parser,20,0,31261,20
e2f1ef5cef672bf52400f35fc33ff4a123c2db16,org.apache.tika.parser,1,1,31261,0
cd6533b19a855d3aeef6243dfae2adece659277f,org.apache.tika.parser,350,0,31611,350
a42f88a863eaebcdb020c55923d1c2d94b18fe27,org.apache.tika.parser,16,0,31627,16
4a0641765bdd155c4a7acafb474becb47fee617e,org.apache.tika.parser,0,1,31626,-1
22e9376b611fd8b5089737288452e8745a5214c4,org.apache.tika.parser,92,41,31677,51
291e16752deafa76864dcbc6bfdf0032c79dbf7b,org.apache.tika.parser,190,14,31853,176
385c9930d65b4263c1bf26781e38a80195c9a1df,org.apache.tika.parser,26,26,31853,0
912357deafb6584c22724a01575d6de43bbadb82,org.apache.tika.parser,56,52,31857,4
d22c2ea763889d96c831fdeb0fc55b82b2e7adf4,org.apache.tika.parser,106,25,31938,81
e269e9cd05f9a111e4d78bedef624939894acb29,org.apache.tika.parser,35,26,31947,9
89dc4d725fc4a1dd3406c462bb0e2b8575c5d34f,org.apache.tika.parser,309,211,32045,98
923ef5d6b2101a7500955b9709967c7277ff5674,org.apache.tika.parser,70,64,32051,6
edf26d44b961e28d6aeff6f0d03c6554dd8bb144,org.apache.tika.parser,12,0,32063,12
5eb3dc1d76fe98ccdf522a0beb69f3d123ccfe98,org.apache.tika.parser,26,0,32089,26
fb7f940ddefc80bbc2da15a271ad0a77e91f3056,org.apache.tika.parser,38,8,32119,30
527f3d72120f6be58735c437d1f6453029485b15,org.apache.tika.parser,14,1,32132,13
ddf2c2a1be1f3b0b8bd792fd5025f1eb7e6b8d71,org.apache.tika.parser,64,2,32194,62
2e6b1bccfd5425f424da9ae8ceca7225a247b3f1,org.apache.tika.parser,23,19,32198,4
8fd2a5298a5dbb2272279ea6b01087e9a96237ad,org.apache.tika.parser,20,0,32218,20
914cafdbbe3748003cfc766c5d9b99339d08ce79,org.apache.tika.parser,108,1,32325,107
ffe67b3852ac83b18543b47a84ec2bd561141398,org.apache.tika.parser,4,4,32325,0
689a717dbcf29f5d2b9804b7ebff6162bc3ec288,org.apache.tika.parser,245,209,32361,36
b27912140e53c0a867a658e1b71962d215106042,org.apache.tika.parser,135,52,32444,83
f15a7fc82495887f5bddc889864d39555c6775b0,org.apache.tika.parser,13,1,32456,12
e99be72add5e1b275cdef123f0a721408a5a7662,org.apache.tika.parser,18,1,32473,17
328b935c08b61bf785ec99952c687f04f7cf989f,org.apache.tika.parser,6,4,32475,2
bb535a0e370a78660bd05da7daf41658f9519a5e,org.apache.tika.parser,80,0,32555,80
833b5e1985f3bb37ee76c85ceddf400b916e3a3b,org.apache.tika.parser,31,2,32584,29
f5021783895b9352cf428f7b7d6c8731aab34a20,org.apache.tika.parser,10,0,32594,10
5c29442148711a86f01ded50bc5e13f1343090c9,org.apache.tika.parser,26,6,32614,20
23eb923e98ac1ee079834334d39a668f5bf231a3,org.apache.tika.parser,6,1,32619,5
07a1590839bff6f16ac19b031a26e128141e19a2,org.apache.tika.parser,306,159,32766,147
8756776cd711c78f7cbe9d2fd7688bbc97ae290c,org.apache.tika.parser,14,56,32724,-42
929c8972a112ac75e5bec8120f0df5d7e5d5ec60,org.apache.tika.parser,7,8,32723,-1
6621297537770ca9149e06ee2977483009f8860f,org.apache.tika.parser,126,101,32748,25
12a974733aa3cbeb82194bfcf843e6d831477d9b,org.apache.tika.parser,187,107,32828,80
89941a2ba1e4b13c3de9c5cf050e4dbf1edafca3,org.apache.tika.parser,5,1,32832,4
95a1cf9448d0454821b2b6e2bd47480816173094,org.apache.tika.parser,281,3,33110,278
7d89a5e455686a945f2e3302f0d201e5e6c4a985,org.apache.tika.parser,14,10,33114,4
2ecd4343453879f8a03e8751ac74ed5f72c2d221,org.apache.tika.parser,43,14,33143,29
8630e56468e1d25920030251d9d97a862cc719f3,org.apache.tika.parser,130,206,33067,-76
99ad6801379ee8e0918d51b7d4bba762694afbbf,org.apache.tika.parser,8,9,33066,-1
efdb4679cb28841da7ba9d8e755596602b630893,org.apache.tika.parser,2,0,33068,2
c36e5a0461b66a7941156dd9ee502c73aa0ee28c,org.apache.tika.parser,5,1,33072,4
49e18e004dcf260c5b55b2092fb90558351008c0,org.apache.tika.parser,16,0,33088,16
dfcf3d4c7cee2dac641ea5b331965ad03ce37364,org.apache.tika.parser,5,0,33093,5
c70b12f68245eb179de7653639ca14c6491007e6,org.apache.tika.parser,1,1,33093,0
56237e39f39092ede166eb790f3d5c0b4644d8e0,org.apache.tika.parser,25,1,33117,24
08d52ec6c2dc71b779e93ab381168dc0b26ca4b6,org.apache.tika.parser,22,0,33139,22
0f1934c10941ad6ad9648b4ca04c528288767675,org.apache.tika.parser,23,1,33161,22
4cdcefd5a87ed11e84ee4a016b989102bc84cdf1,org.apache.tika.parser,20,5,33176,15
4f920c7bc5fd262c2a83fe44a7fb7b7bcb2798b7,org.apache.tika.parser,49,1,33224,48
bf24bc0a11daa83ab707c1576a5605609b35d786,org.apache.tika.parser,21,0,33245,21
a06209b1d5e263fd579afe66318560deeda7f66c,org.apache.tika.parser,17,4,33258,13
9c0f4ca22c79a049b9459ce6f4dba8ba527da5d2,org.apache.tika.parser,22,1,33279,21
8b68138f77faf7d883455f5aeba908e52f5ddfe0,org.apache.tika.parser,1,1,33279,0
a64d33c78c143f401d2d7ef795872fcc35fb2200,org.apache.tika.parser,7,0,33286,7
7b76a7ff27780dc866240d43dc0d5deef4846416,org.apache.tika.parser,7,3,33290,4
7d6167539dc165877b62ca1530144ff14931f532,org.apache.tika.parser,1,1,33290,0
71629f0b696e4bd7de892c601c91f2d5eade23dd,org.apache.tika.parser,48,37,33301,11
355eba97dfd9ae2e61ca856f0c70e001b203a0c0,org.apache.tika.parser,37,4,33334,33
a3f156bfa445f5c0172a90107c6c15402bfa120e,org.apache.tika.parser,29,1,33362,28
963100eb1806048809b1fb2cb5076afdd640cdfa,org.apache.tika.parser,0,64,33298,-64
60ca6ada25d6643c50831bdd28416f3a60153c20,org.apache.tika.parser,4,2,33300,2
771e368ba531ef5063b89811d98a3c756920f870,org.apache.tika.parser,41,12,33329,29
12f408436f7f142b1269be3f89fee3817a1c4453,org.apache.tika.parser,16,5,33340,11
ad9512ded721077a4e412a35d7fc74df99bc0614,org.apache.tika.parser,41,0,33381,41
01c02e671a82fc89fca8748175a741a5c5605962,org.apache.tika.parser,20,15,33386,5
7260050594e7a13283d2dbfd1a079149a63d43ac,org.apache.tika.parser,2,1,33387,1
3e7e7c95e68a8b3be8204e9c4120cc8199b5df57,org.apache.tika.parser,7,7,33387,0
71166dea776a676601d35bef3922717aa2d56301,org.apache.tika.parser,10,4,33393,6
7171855cd159df475f3eaa98177916616288db30,org.apache.tika.parser,22,1,33414,21
e4e1f7d24631d713de2ec32779a7a3036c7064c4,org.apache.tika.parser,25,0,33439,25
c8dea65fd592805f446f719247070fd186ddc69c,org.apache.tika.parser,1,1,33439,0
3df2f5907269e6b6652a76b526f45088e11c57ff,org.apache.tika.parser,189,13,33615,176
68e5671c2365500dcba2ad89e0932afe2065010b,org.apache.tika.parser,857,51,34421,806
956e6401a9d4554e0980c7c2e3dd6a4797bb34b2,org.apache.tika.parser,2,1,34422,1
ef226f48cf387d1d734a3a0bb5a9080d806a81fd,org.apache.tika.parser,7,0,34429,7
6e9e7cc8dc4791d41e48b7ef423554ce439b3a76,org.apache.tika.parser,32,0,34461,32
00ab3e05d3cafc8429747b175841eed436f9f347,org.apache.tika.parser,5,4,34462,1
5ffe387253086d52017d32f7d5b20cbd912d56a5,org.apache.tika.parser,17,5,34474,12
aa18a7989e73510ac148ef56a47d151385e3b268,org.apache.tika.parser,40,39,34475,1
c1dfba214c731fd03468f800b9a8c64ee80ced8d,org.apache.tika.parser,206,2,34679,204
7b30eb89c40af2818f1a73d7496432ac308cc594,org.apache.tika.parser,38,38,34679,0
76cfbc18533c65ecfc07b3233015b9886938bf08,org.apache.tika.parser,46,0,34725,46
ba80052ad7c7992a15aae7445488bed7584187f7,org.apache.tika.parser,132,59,34798,73
7f080de7859a4261bccc4f565455b9abc9dc7d43,org.apache.tika.parser,1,1,34798,0
62d5ad3c044b75babd6d6be22a4f06b726c1d1ed,org.apache.tika.parser,51,31,34818,20
a7e03539f9944f4847164b4bfa14b1f2db077331,org.apache.tika.parser,42,4,34856,38
1e8e3c86d433337100aabfd9e22ce4cb2998ea9f,org.apache.tika.parser,3,0,34859,3
c183694b20f785371539284a3d6f84d29dceea68,org.apache.tika.parser,23,1,34881,22
9227e9f3d5090be28e28639ab92732c5be0507cf,org.apache.tika.parser,3,3,34881,0
ceccd0b65b0a24bf44f4566a94c901c7c40135f6,org.apache.tika.parser,8,1,34888,7
0332d28173171a95413507fa6b019f13e7e1751d,org.apache.tika.parser,77,7,34958,70
8a04063e6d7e7b0fdc0ca3b8b96a15c980b2a41a,org.apache.tika.parser,429,187,35200,242
4a59adec871e85e609f68bc5bb2497612eb97926,org.apache.tika.parser,64,37,35227,27
dcbe0d27ed0575fab0f2176503e5a5bc1014dfe2,org.apache.tika.parser,202,7,35422,195
ffc3b3cc73f7f931ac82425d9a0803e1c672aba3,org.apache.tika.parser,13,7,35428,6
2a36fcd63ddd3234b7f34e6814972bb62aeb4bc9,org.apache.tika.parser,692,240,35880,452
9385906e6a5adad9f820aca6e8138dce41ab122b,org.apache.tika.parser,7,3,35884,4
8d794b56dc413f41f0cb0a288aa55b55a7f198e9,org.apache.tika.parser,16,63,35837,-47
3dec31215d95917e7f6f5113ce966d2d61231800,org.apache.tika.parser,7,3,35841,4
2608c791c41fb82a55fbf8718e748b4d587032c5,org.apache.tika.parser,30,108,35763,-78
bc8f90a5d1fd8286f04fa7088c324db96e8cb36f,org.apache.tika.parser,37,77,35723,-40
2942530968d8b5a990b369eb619a7bf371c14c5c,org.apache.tika.parser,80,180,35623,-100
f1c5c6912873837a3317a55d5426a271b1874322,org.apache.tika.parser,39,1,35661,38
f570a3b5987f8c49a97528dc7f8ac6a53c58238c,org.apache.tika.parser,213,0,35874,213
8fd76a41b32b80353820d4a8bdaa08de5529f7ee,org.apache.tika.parser,71,0,35945,71
7d3194a3be19dc81a425ad4247b85dc7891b8660,org.apache.tika.parser,103,30,36018,73
33280e0e96a3a6000e3bb747667ffca002752595,org.apache.tika.parser,0,1,36017,-1
78a7ceb4e46d1e8b99533dc1261a42773ecf099d,org.apache.tika.parser,133,0,36150,133
1ca0efd92bf7068fb1ff0366dfe0f55612d56068,org.apache.tika.parser,97,44,36203,53
0e3c51ea1dd800ecf70f43ebdeb9559c07b72aca,org.apache.tika.parser,6,0,36209,6
9f869d2c3033a67f0b5588a1702748da925cc894,org.apache.tika.parser,3,3,36209,0
8316bb2f8a4439b4299e75e70e17188301702fb1,org.apache.tika.parser,121,0,36330,121
aae0f4ef4c4aa28542382b342cf8b8766f500f86,org.apache.tika.parser,0,1,36329,-1
98c6957ffc4514eeebab6bbaf6ed44ac22c09390,org.apache.tika.parser,232,0,36561,232
099c53cf71ee8ac31374b56c0b4209056a359b63,org.apache.tika.parser,198,5,36754,193
3cfe5ad70d02b22c8464b6073de9fe55830964ac,org.apache.tika.parser,109,5,36858,104
cb6c9b845c0a883ff35a30fb0018cccfe4deb024,org.apache.tika.parser,36,1,36893,35
bb4b8f1fb00a5b85795aeb8acc12b49e7437b8d6,org.apache.tika.parser,128,125,36896,3
a504a1e7603f9b21c3062ef2afa200a90fdaa930,org.apache.tika.parser,95,95,36896,0
a8e46e9d09040d8aa273918d7bd3363a3a3f3e15,org.apache.tika.parser,56,8,36944,48
41c6749f7372b6ac3a9acfd309a4aaca3e077a07,org.apache.tika.parser,21,8,36957,13
d145ee6a07b53fdf66cea0a6a34e9b12cf0407bb,org.apache.tika.parser,23,11,36969,12
ef61057b0f0ad94c69dd8969177c4f1e0d264613,org.apache.tika.parser,26,2,36993,24
fe90fb4ae70bc94517dfef9c578f4c1a507b1894,org.apache.tika.parser,272,304,36961,-32
8a7965a815ab7dd1ad1af92f478f7e9a0be9eb67,org.apache.tika.parser,194,119,37036,75
626625cdd03b37e5f9393b5aa67762b8c0118ec2,org.apache.tika.parser,80,20,37096,60
398f50f51fb363b9aac60ec50f54d977089ef957,org.apache.tika.parser,2,4,37094,-2
55310ec7f4c8f2bfe6ff29485dfee156e6c9de84,org.apache.tika.parser,915,25,37984,890
2ddb7595b138dd845c6608216d1f98fc1cb2fc60,org.apache.tika.parser,32,1,38015,31
a570bfb2f3c4e7cd99f25d2ba9f39794f2a492b1,org.apache.tika.parser,6,6,38015,0
e0db4161081dcc0d926c5a883d3b4d4cb7d4bb51,org.apache.tika.parser,56,11,38060,45
3a9afb5d5dae8b5e4db84679ec39738d41d8fd75,org.apache.tika.parser,92,1,38151,91
0a329316d6cca111e64a71d2d0b81327018a7281,org.apache.tika.parser,3,3,38151,0
b4c85685e1bb86d61f5d6bc825af7afa478a50ab,org.apache.tika.parser,5,4,38152,1
fafcf755b2632ffc777d0cf65e47caab7d97aa76,org.apache.tika.parser,60,10,38202,50
54afc7a6dd4d43dd847d9fab658b4162602e89c9,org.apache.tika.parser,25,4,38223,21
359aae57ce045de191a14bb369e7980154deffc6,org.apache.tika.parser,17,0,38240,17
6b7db9975871d6a9426fcff284661b33ed079448,org.apache.tika.parser,0,6,38234,-6
f033bcf5dff844fc01baf480596582b89095435e,org.apache.tika.parser,8,1,38241,7
821e1974dba7803211de0fa7759d3ee6e162ae40,org.apache.tika.parser,4,0,38245,4
c2da98e37eaff64a0b12a253b7406385cd80b253,org.apache.tika.parser,42,5,38282,37
8c0119b9b5d388ecdf8c90cc568fb493c1905c3b,org.apache.tika.parser,44,12,38314,32
0e7ea0a025b9d32dd2f41bdd25cb005999d4dfeb,org.apache.tika.parser,300,23,38591,277
08a402913f47d405dd01747452833a771f5accf7,org.apache.tika.parser,11,11,38591,0
d0ced9671ef45210a1d0545f32281f3bd7724862,org.apache.tika.parser,15,2,38604,13
375fde60b42c44b57c6931894ddee177b063fbae,org.apache.tika.parser,27,3,38628,24
841c587bcd64a75a8badf51eddb62d10360ba69d,org.apache.tika.parser,2,20,38610,-18
c1a9be02b8fb9414f26daff89d170e048ab28d00,org.apache.tika.parser,21,10,38621,11
7cd4050fef9e3f18bbb060c142c4f0dfbb515101,org.apache.tika.parser,71,3,38689,68
68f513f1264c4e14238058549d399dd3c0509444,org.apache.tika.parser,7,5,38691,2
15bc1b3a1c5e79c007754760eba5748e99b01fc8,org.apache.tika.parser,2,2,38691,0
b97ef3208fe5848c96c86d6d7b6a6bfb962e0568,org.apache.tika.parser,25,1,38715,24
d943c10d8ee8068523f196f68af2090245815735,org.apache.tika.parser,6,1,38720,5
468698dd18a0fb01bbc6554bb5eacbaf42b5c59c,org.apache.tika.parser,15,5,38730,10
ccaa9a386a61ba6f08d132eae2aed6780e8e310e,org.apache.tika.parser,225,0,38955,225
6a306fbbe256c267cd1c5a863c78707f4c43085f,org.apache.tika.parser,36,1,38990,35
3a502441b7866a5c447c2c513216d0c9601c1f31,org.apache.tika.parser,36,86,38940,-50
a9a5c03c4581fc43e0e17372dc4c4863e280e762,org.apache.tika.parser,85,40,38985,45
5f27b9717ba084f13814a800dffa511e523ea183,org.apache.tika.parser,158,0,39143,158
ba7430903775dcca795073fe32b0aae4999635b5,org.apache.tika.parser,27,5,39165,22
9d189e6803272835dd50a78e0dbb324b0f98eb54,org.apache.tika.parser,111,98,39178,13
3aa77388e9edb77853181a7cd3e479d14e746c7a,org.apache.tika.parser,2,1,39179,1
9860b74af1e19ec7a88cccc298f9dcd86d31d3bf,org.apache.tika.parser,1,1,39179,0
070b30c2094b637506a8fcb8597c830b1fe6c3c4,org.apache.tika.parser,1,1,39179,0
efd714708465c66de6f43c74a88f3f375137a998,org.apache.tika.parser,15,15,39179,0
adeab5504b464a8e212521d4c372d6a3d16e0d80,org.apache.tika.parser,31,33,39177,-2
7ce1b27e112a7f5fe751fab42ce8bbf97ffac93f,org.apache.tika.parser,0,1,39176,-1
f086cdfe7ea5a6e331b7b7025cff6629faa9f6ea,org.apache.tika.parser,1,1,39176,0
b9e5ee125ab7a1de0ae11f3d21cf46a2b711acb4,org.apache.tika.parser,21,21,39176,0
424c0ebd503900bdff481e059a3a326dc7add814,org.apache.tika.parser,16,16,39176,0
628842dc89c938f5780b3926cfcdcf12fff42ee6,org.apache.tika.parser,2,24,39154,-22
79211cc7a400f3b0b066f0a6401dee1c2fa9c90e,org.apache.tika.parser,35,60,39129,-25
51377f1380d71e1af063dcd8d3538cd3e9d294c7,org.apache.tika.parser,15,15,39129,0
3b74476bd0a65a20d09a3da709cfe7ef1d6ef266,org.apache.tika.parser,3,3,39129,0
d4fc8dd93894078abdf14193953e1b3ead7fe0f7,org.apache.tika.parser,0,1,39128,-1
f1d00dbf40f16ce8669628951b813d7972c07c45,org.apache.tika.parser,33,14,39147,19
1c7f1bcd1c7e3dcdba6495f6f9ac217522a6485e,org.apache.tika.parser,11,6,39152,5
4fefb499af9046c40c69876bee907b71d67aa07a,org.apache.tika.parser,250,211,39191,39
cc4898b45f1ee7384ccdd150d411f5f700212cd4,org.apache.tika.parser,33,8,39216,25
aeebd70b680515661e7aa41bd79fb1a75d0db507,org.apache.tika.parser,3,0,39219,3
e00b441791b994ccf5e3335ec0d38c141dc4fbda,org.apache.tika.parser,21,2,39238,19
5c0089a6a30961b5397e08e0ebd10be403541db3,org.apache.tika.parser,67,23,39282,44
204532630e37f76817e8677c58301d22ed576fae,org.apache.tika.parser,24,0,39306,24
b4888806e35e15b526843ca8b5ff89d38cab5baf,org.apache.tika.parser,137,7,39436,130
d0dfe796e12e08339ac33c7e6d3ed5a0deb936b1,org.apache.tika.parser,23,0,39459,23
8c1ff5652c8e2db1db3464f04d603339c6228529,org.apache.tika.parser,7,1,39465,6
2336b0cc6d30437e728a8542e4b62573682c645e,org.apache.tika.parser,1,1,39465,0
6cc0e11b91ee5ebe97ea91fc50a76074f45829c2,org.apache.tika.parser,221,143,39543,78
7e6448348853234fe76c732ffeccb76200fe464c,org.apache.tika.parser,72,16,39599,56
a4cf450692c57db8c4ef1d50348df91f5b04f82f,org.apache.tika.parser,1,2,39598,-1
50dcb7b3e93ad26b006de513dcd51fef4a7d67f4,org.apache.tika.parser,19,19,39598,0
91d1f000bbf63fa5fd56299763ef4d6ada7e878c,org.apache.tika.parser,9,9,39598,0
1c660bc33148b68cbeb88b5384c364f6c16962fa,org.apache.tika.parser,5,2,39601,3
a07a70ab60068e36c2df3059b89d067f01912631,org.apache.tika.parser,1,1,39601,0
32ebc7a462dedbc822f87a5099b49357003fbf9d,org.apache.tika.parser,1,0,39602,1
a9406a5e17991af17b42e3cfee97d2060ddcb520,org.apache.tika.parser,2,0,39604,2
d0f46bc5d837b4d029673f399c1d3654873ca307,org.apache.tika.parser,36,2,39638,34
783594d2169394bb29e19afe8da900fcf264ee37,org.apache.tika.parser,86,82,39642,4
cc922f459b20e997c2545bb1902aef6123eedea5,org.apache.tika.parser,23,13,39652,10
0365ed2e430f3513931c01994e75fa55d1fb1b01,org.apache.tika.parser,1,1,39652,0
fa93128a4ddaab15415193ff3d376b1612a1d5fa,org.apache.tika.parser,15,12,39655,3
464a9087931540b18b016d07dc39fa5cb21c60d4,org.apache.tika.parser,546,0,40201,546
853df89a08ee8dbc96b2620aa907c66f699233ee,org.apache.tika.parser,603,63,40741,540
718776dad5120682c3ff09fda2aa8898520ff3ab,org.apache.tika.parser,0,1,40740,-1
ec40cb6bad027e87eb32f4f20cfdb9fb0626f9c4,org.apache.tika.parser,24,0,40764,24
c20630790bfaaaa08626456a1ff8dc56b073aaad,org.apache.tika.parser,5,0,40769,5
b32b0610586827dcc7511bf197bf968253807ef5,org.apache.tika.parser,3,0,40772,3
af4bca291d2a92cae9e83cca25eff0abb49687bc,org.apache.tika.parser,49,28,40793,21
4f421985cb2d1c75b8c2474719ab2d5e38d2793e,org.apache.tika.parser,61,10,40844,51
e8fac5b3060b8af39ff787fbf8038980b999c611,org.apache.tika.parser,27,21,40850,6
ff8e253c1ce8d3ccfe35b0c12fdc72937dba5af8,org.apache.tika.parser,12,6,40856,6
c53ad42d97ff82d03820b9ac3c1f03e6287400a4,org.apache.tika.parser,6,7,40855,-1
d600793f89bc2f03dfd9d258b9eb3942985fcc7a,org.apache.tika.parser,10,1,40864,9
2335991f60135e641413a464687f75c15b82b21c,org.apache.tika.parser,9,3,40870,6
bac4ce44ac0c37ce60adbc4ad76447be6c5c5bdd,org.apache.tika.parser,7,6,40871,1
ace2ad96b75fecffa2c54d220afe6c4f2b0d36c4,org.apache.tika.parser,7,1,40877,6
a331b5e0aca15b999f7355339707735376441dd7,org.apache.tika.parser,566,0,41443,566
63a2a6b85744363adc168ea76b58e017f6e8b0e7,org.apache.tika.parser,16,11,41448,5
fa4d2bf5d51b1fdf9a8559b0949b9bd4dff79636,org.apache.tika.parser,29,7,41470,22
eb7202d524dbf45d2d0e21b473e73e5401ed10b9,org.apache.tika.parser,19,9,41480,10
cf55425220f3c0dcab2fe6318e19560bf4c7827b,org.apache.tika.parser,242,226,41496,16
fe06af65557221eefc7cc7290a61cb4e6ebc6516,org.apache.tika.parser,1,3,41494,-2
ccd594622ec4befb29bdb8245cd2b2d5660f0b81,org.apache.tika.parser,0,9,41485,-9
42cebedc5a415b5f9fe32de184ee6dc9e6fab9b9,org.apache.tika.parser,7,7,41485,0
4f4ce4c646b7d9a196bf9edacefaef4783c89cd7,org.apache.tika.parser,16,4,41497,12
eacb983cb6155dc00e98f5ad4c9d71244b7dba83,org.apache.tika.parser,14,14,41497,0
0aa8bca3ede9bec545b7228733df67905b7e8663,org.apache.tika.parser,7,3,41501,4
3b2fba4ece90530849eb3fdad9bbf12041220b03,org.apache.tika.parser,91,4,41588,87
069ac2d9ff12192b54f98274f370560f8faba00a,org.apache.tika.parser,69,0,41657,69
2d05a8a85e7b31b4b21111ad380b131780f09ef4,org.apache.tika.parser,2,1,41658,1
65977bba2a5900c43dbb9f4c8512daf38b9163b5,org.apache.tika.parser,507,391,41774,116
ccc1fc0df0304122e7e6d57c6897dba49a37854c,org.apache.tika.parser,25,5,41794,20
1cc2725cecf73a1156af53d21801a9196154f389,org.apache.tika.parser,29,27,41796,2
746de4d60f1ea1e847dbd9fc1b940c53b874d787,org.apache.tika.parser,1,1,41796,0
a0d5a4f7fb1f0eb938f9b5d9c894f0337cfeecc5,org.apache.tika.parser,1,1,41796,0
74c231a575c9ac307b617c2c322d0f4151baeb64,org.apache.tika.parser,26,0,41822,26
bb9380c0e07084a65773ef12f014ec1b9ad5fbc6,org.apache.tika.parser,14,21,41815,-7
ed77de42dbeb0b1fb5f7fafd42b02b7f43805929,org.apache.tika.parser,1,1,41815,0
0de5e6f96c2a20c93b3e6f99aac80c014d3017d3,org.apache.tika.parser,201,0,42016,201
1f32c70e2166cca831a9f52a5362583dd11e3cf6,org.apache.tika.parser,61,4,42073,57
1a317d10d26c88c02b5a3f5c9d9bfb8e88e2a2b0,org.apache.tika.parser,65,29,42109,36
d6d1d22df50ab86d2ac156229833ab5a200e1f13,org.apache.tika.parser,61,43,42127,18
21094020bb430526dee7d2a87f5b3a7dc30af338,org.apache.tika.parser,28,25,42130,3
1233a93d97e9fb7f566b0b4f52d3733659f0ac7b,org.apache.tika.parser,20,5,42145,15
a8edc724052ec964111cce3a1193a4e078fa8ce8,org.apache.tika.parser,3,4,42144,-1
7dc73cee673ffde25441b1adba6d467873ed134c,org.apache.tika.parser,35,0,42179,35
75230ce9cc30db0eb9dc79c711a762b14d39c3cc,org.apache.tika.parser,10,5,42184,5
f3df5ae5a98c31220a5946b70daa3fc2fd3752b2,org.apache.tika.parser,1,1,42184,0
5a7216e83d99238080e29ae2f46864113aaca3c6,org.apache.tika.parser,7,1,42190,6
78265ea1fa04dc8fa4d18d152663da7871199018,org.apache.tika.parser,482,485,42187,-3
9277ce62ac43d4d684bfa660c413deddb30db091,org.apache.tika.parser,32,46,42173,-14
02f4720a4198b23415edd50c49645237cb2b3c6e,org.apache.tika.parser,50,47,42176,3
f5ad49dc58e0309b88084f6dda2d73fea3612804,org.apache.tika.parser,11,2,42185,9
bddf67d58340860dfe95d54e6526f8003dade2b9,org.apache.tika.parser,3,6,42182,-3
5f6845257016bfbaef26e998edd8f660c5711ac1,org.apache.tika.parser,19,6,42195,13
895ebb79404e3113766a0ec4b12c3a100294a96b,org.apache.tika.parser,15,14,42196,1
1843bb593e6d3c479ed4b25a56883e48c6af0d32,org.apache.tika.parser,37,0,42233,37
5cf7785cf2540cc8cdfd7d21b4f8bf540fbdc55f,org.apache.tika.parser,35,1,42267,34
0a176a5aad749a0b15559b705b906937760d4a77,org.apache.tika.parser,5,6,42266,-1
d7f253f852f9e179fa0f51cb912c33bf63b7f1a8,org.apache.tika.parser,5,13,42258,-8
192c0d0c9aafdf660e0b311b7fc2da11ecb9d572,org.apache.tika.parser,15,2,42271,13
4533e06da0231f88cf8a5d1b6a3708841e3c6880,org.apache.tika.parser,11,3,42279,8
9f8fc77764e781f88afce7c13d36c9967caf4ae4,org.apache.tika.parser,50,3,42326,47
41c09d78e82af9ddd050cf02d5a14919e9e297fd,org.apache.tika.parser,95,94,42327,1
9ba366d064bbc9acf143fc80e4fcb5f63c4b5173,org.apache.tika.parser,238,238,42327,0
5d3fc7f886223b40d755bca8fa45a171b3899268,org.apache.tika.parser,0,5,42322,-5
c9887c1db88576370ffecbb206b840d0ae330b78,org.apache.tika.parser,20,10,42332,10
484fe4ed66b39e9a11f44753e84e93384fc74201,org.apache.tika.parser,8,10,42330,-2
e09cb44e8a0bad4bf2b51591ca5f13563b1c79c3,org.apache.tika.parser,242,0,42572,242
b9b8537f0e88becf6285a25a20d37a2afaceadf8,org.apache.tika.parser,72,30,42614,42
eebeab1076116daea03217d5bfc9ffb48d4fc997,org.apache.tika.parser,114,116,42612,-2
a729485005e4556e54151fe2e714e60a89f4eff0,org.apache.tika.parser,33,37,42608,-4
1b462d3e4544a0e3e423eb686ec78aba5cc1814e,org.apache.tika.parser,13,20,42601,-7
a7bfac667871e7a37a3a26912d4c51777e25f3b5,org.apache.tika.parser,80,83,42598,-3
89eea5fd18f92e8280abeeccb09556e3dde271f3,org.apache.tika.parser,130,127,42601,3
7cd31ee5aea3b05525b84b0bd9b83df043f44381,org.apache.tika.parser,9,0,42610,9
a9f559d7a4921578cfbc827ae89f5dd0b80b7d79,org.apache.tika.parser,3,0,42613,3
32985edf6e025da754f974f951ef3ae1c4c61949,org.apache.tika.parser,33,3,42643,30
7b7ad9596116b402a938d5ded50a2ef621677c03,org.apache.tika.parser,39,16,42666,23
3b1d2498e25d51817c47e470a66c9251210b9dfd,org.apache.tika.parser,8,16,42658,-8
8abbe99f47ed22f43097421264a356d2311801b4,org.apache.tika.parser,31,4,42685,27
24faaa980924cc9aedbdcdbecdd6a9a19f4fdf1e,org.apache.tika.parser,36,6,42715,30
58b7c17d1833caffd5e8693d656a6efc02463c43,org.apache.tika.parser,58,31,42742,27
ab00944dd991827196644df194247d5052ca8af3,org.apache.tika.parser,99,4,42837,95
2f5148aa2f9290c9611d16d0b3f7eecf0e0a1874,org.apache.tika.parser,2,2,42837,0
9398ed2fe64411f8e7d32d6d634b8300e796731c,org.apache.tika.parser,12,1,42848,11
892f3a8b1e44efdf86ec9aed0887de7afcbf01ea,org.apache.tika.parser,152,210,42790,-58
ff3471490258faca2e86c480e93874fed07205cb,org.apache.tika.parser,3,0,42793,3
bb0822ab4553f921c1f840ecf7c96c40304e732a,org.apache.tika.parser,11,4,42800,7
07892ac0040408174c018f738918ad161e442a2c,org.apache.tika.parser,77,33,42844,44
c4b139328856b80573baa5c4fe5e33f8d95de3fb,org.apache.tika.parser,177,0,43021,177
8d9ddf9d7f2b5809b81e262fad3181a4dadb2e57,org.apache.tika.parser,21,33,43009,-12
0462e2df441e42017b034bbd7a081dfa8eb57288,org.apache.tika.parser,2,2,43009,0
1916f12e068c277f9ef13df7eef44f718d551aa4,org.apache.tika.parser,14,12,43011,2
415e35c57f3dd813b2a7fb322eb0e1702ead132d,org.apache.tika.parser,74,0,43085,74
1cdc9aefafa5516459f6d79c0eae4e9e14e89e52,org.apache.tika.parser,97,3,43179,94
169ecc8ee1323971e46ad8777792b9575eae7589,org.apache.tika.parser,708,0,43887,708
e12bb7a68d1e1cf60bacdbd2e68afe6b0b6863a8,org.apache.tika.parser,38,17,43908,21
8fc3a0925db66e3a15d7ad5f790f0201ed73b214,org.apache.tika.parser,83,11,43980,72
8ecbab905d2acaaa29ee15e7f25af2fc79ef558e,org.apache.tika.parser,1152,0,45132,1152
c19701b5ce47d672000997a8f22d248a030cb16c,org.apache.tika.parser,387,0,45519,387
99b53cec502b9266b1e47aa98170e976aa1ebe3d,org.apache.tika.parser,128,0,45647,128
11787f5fac99e14261dbe792e75549ef8fc19e42,org.apache.tika.parser,2,8,45641,-6
bab243e2863646ae6639a51b81867fa029bd9d68,org.apache.tika.parser,154,42,45753,112
960cd6889cbf7338d3040071632881cf187f8a60,org.apache.tika.parser,392,0,46145,392
9ee3a34ef15f161f956d0d6a4d220e56cbb9118e,org.apache.tika.parser,24,4,46165,20
ecd7ce84b76fb7ec27ab5c81b1d938f7051e1911,org.apache.tika.parser,0,19,46146,-19
aca3dfa1f086d2f6cbd6ebfdccfa9333ab1fbcf1,org.apache.tika.parser,2,0,46148,2
d1e8d7176952d7e82e2d72ae08b2ee40df17902e,org.apache.tika.parser,505,38,46615,467
15303fe8bcb1b975be727041c0094e471f0b801a,org.apache.tika.parser,4,1,46618,3
0c81e7a4659c1942b189db7c8342964375cda2de,org.apache.tika.parser,516,387,46747,129
0a92ecfbf66a319354003a0da736efb7c2c9a927,org.apache.tika.parser,18,0,46765,18
db07978f53a1f8eaa0c866bb5585e8791d63b962,org.apache.tika.parser,36,3,46798,33
86b897d84e4974e885a5d2e020f37b6878e4ae80,org.apache.tika.parser,4,6,46796,-2
3f6d06f8b46a14eba6011d781e5e5a86b5043896,org.apache.tika.parser,11,0,46807,11
257a53b8a83caa5de9067b9c3b3b5e2b356f674d,org.apache.tika.parser,11,5,46813,6
794595c85cffc6cc811c60b1d8ae6fd3a341bcb1,org.apache.tika.parser,172,11,46974,161
c46f54556357b08dc0d092cab3d316a1205b7d51,org.apache.tika.parser,15,1,46988,14
19c87d948588c84927e3b03babbabdf4310a349c,org.apache.tika.parser,1,0,46989,1
4cf0ab4eff5d76709c30ccb793fba296b4f95a0e,org.apache.tika.parser,11,12,46988,-1
bd4798adef20b2531637be6b13b73e851e805a39,org.apache.tika.parser,136,123,47001,13
e5ca726329bfda06418783fbac38332293b34794,org.apache.tika.parser,4,5,47000,-1
832ba70a913e706ba4401f2a0e6d15a13cf267d2,org.apache.tika.parser,2,2,47000,0
fe4cd58cced0e15f1848afbc2518ab4a66e6867f,org.apache.tika.parser,29,0,47029,29
5a6626c09de1a7dd904c9456b60ffb20f573f7f4,org.apache.tika.parser,4,1,47032,3
375274a100048f3808aa7582e71bf51200b88a14,org.apache.tika.parser,4,0,47036,4
de00e27abdba193cace29950dd75edb2f44cd766,org.apache.tika.parser,2,1,47037,1
7b979a89bfa59b58a8aef16012bf86fa5cd5229b,org.apache.tika.parser,432,0,47469,432
6ce4a166486eea12e9987318da24f82aa4a072b6,org.apache.tika.parser,2,3,47468,-1
671b314b1c25c3d4b390a61ef6c0d7d03b062806,org.apache.tika.parser,21,1,47488,20
5f506c1627d442f9366a1eafef1a0195fa24bf79,org.apache.tika.parser,12,129,47371,-117
3fff336bb66aaa60e9b0a4c13d4967903ba62ea5,org.apache.tika.parser,10,3,47378,7
6194e6854392740a157cce3bb252af10244af8af,org.apache.tika.parser,49,12,47415,37
aecf60c2b2718e03026159b1155a23a66ee2d7db,org.apache.tika.parser,177,16,47576,161
1e33ed3bc35997cd4c8bcad689cd460313ea5605,org.apache.tika.parser,3,5,47574,-2
13a280bea8dfb56fafdfa8b31ffee8941077a98b,org.apache.tika.parser,15,12,47577,3
7d231d03247b9171dcce6e1758deb5c49560a6a1,org.apache.tika.parser,66,18,47625,48
ece254a45588281d6d00b383cd9f7809dca04580,org.apache.tika.parser,60,1,47684,59
f2c263dd409f62c6c3520e48816c9fca9244e854,org.apache.tika.parser,365,394,47655,-29
3e9db56e11340c06c39e71df4d320033eda5810c,org.apache.tika.parser,7,3,47659,4
35090b30645cb20fbbc8c125850e303dcad5c24f,org.apache.tika.parser,3,1,47661,2
7ada2169584970ab9cc8d032c1571dfae78d4fe6,org.apache.tika.parser,112,27,47746,85
b40b92e8129bf4507a5248f03e9a8628a0bb23f7,org.apache.tika.parser,1,1,47746,0
c6ed61372bd004dbe6ab3e9e2d7c1f73eb657350,org.apache.tika.parser,2,0,47748,2
54e671764be5e9731ba37c059bfc96ed31bceb23,org.apache.tika.parser,0,2,47746,-2
40e07577cf087ee0eac4c6f11388bf4d252537fa,org.apache.tika.parser,10,0,47756,10
7ca5ec0aecea4092b6a8399638444ae4a335137c,org.apache.tika.parser,592,0,48348,592
79c07dfd9e4eedf90328aa9409017ed8a8e82bf3,org.apache.tika.parser,453,0,48801,453
c3d82a84eb5a5105672b3b237c139c1921020944,org.apache.tika.parser,3,18,48786,-15
ca0676ffaf6fb7986adf839a0ca97b34f0b449ca,org.apache.tika.parser,0,239,48547,-239
761467a520ac864ed4137525f629ad46af58ca73,org.apache.tika.parser,0,57,48490,-57
9f255bc73011de43ef115e11c3fdf5438394bc42,org.apache.tika.parser,1,0,48491,1
90ff7e32c5845138ef469cd06212545bfd0d789d,org.apache.tika.parser,3,0,48494,3
88f140f5cfd63202a48bab7a43e2c6cae05ea8da,org.apache.tika.parser,1070,1070,48494,0
345d33f0b53110047b9a2170f6ad720751fc8386,org.apache.tika.parser,2,0,48496,2
8df88b0dfb471216c3df42bbcfb44ffe3f5a6356,org.apache.tika.parser,95,0,48591,95
84b7ca2c1c0c5df3e20be2992afd678a87c1dbfa,org.apache.tika.parser,477,0,49068,477
3ab3c34470bab4ac05395cef090e5c51d24000bd,org.apache.tika.parser,206,204,49070,2
c38576184b91c4e74e644b18f1315255d16a3981,org.apache.tika.parser,3,11,49062,-8
1b23ca5207fd1b32ce4a0d3a5367a820c5780e7b,org.apache.tika.parser,17,0,49079,17
309752746d8ab0d8fc713c4f0ffb766c4135a07e,org.apache.tika.parser,32,13,49098,19
ba78bef63a9b267be31bd3987e3420bcfd249c1f,org.apache.tika.parser,11,2,49107,9
227ef0111467325ac217e8f0f1682108dfa4717e,org.apache.tika.parser,1,1,49107,0
7ec0a0bc9a4d8c757344d1058257696cb4d02efd,org.apache.tika.parser,16,0,49123,16
5239ee7922c52a6a5281f3671ee9b31f7707f5bb,org.apache.tika.parser,2172,2162,49133,10
cc326059cd05b9df51bbc82fba6528cb09f4395e,org.apache.tika.parser,115,11,49237,104
9413f4547eebadff017226c66b4cf87376433075,org.apache.tika.parser,0,1,49236,-1
04be3280412570d8923594b6f3df42741f098008,org.apache.tika.parser,4,0,49240,4
619982004378e65da633ab79fd94359565bfb8f7,org.apache.tika.parser,874,0,50114,874
fa5e6668625ced3d6dc093ff73229e49c5f72133,org.apache.tika.parser,641,645,50110,-4
952ba27a5003bee71ef62593374e3bfde762d635,org.apache.tika.parser,18,0,50128,18
b93a7d267f8d1899354c5e2b8c1c56651e50d99c,org.apache.tika.parser,39,5,50162,34
086501e0e6db3e396ae44b210d16113cf09a65b8,org.apache.tika.parser,5,3,50164,2
826bae28ca8046ab15f399187bb49b071d64c5ba,org.apache.tika.parser,1,1,50164,0
80a1126072d9af786e09f30a4fd951b45c844cec,org.apache.tika.parser,42,12,50194,30
5cdc797a9fe12f46423feb2588e94d5e5358b56a,org.apache.tika.parser,291,268,50217,23
1a3749fa632fdb8ad0bcb2cea673113031f9b4be,org.apache.tika.parser,0,2,50215,-2
90a2202b5b4a75e7f673bfb42a912cb97ae6d26e,org.apache.tika.parser,540,6,50749,534
444dadd5eb090f6e2998507e444b2014905cb90f,org.apache.tika.parser,1,1,50749,0
2764fb8606964c3350c781ecf5df4042706b4099,org.apache.tika.parser,18,24,50743,-6
4dcfb74cf702aa88a94f58ca79ede313dfb45852,org.apache.tika.parser,9,9,50743,0
9a8798b8e19b2149e1f5b678804f328dd0be6686,org.apache.tika.parser,18,5,50756,13
5f3acd22272dcaf8b946feecaf0e1bbebb6489fb,org.apache.tika.parser,2,3,50755,-1
a4baebe62c9a29c71fac00b59657f508c681edbf,org.apache.tika.parser,0,4,50751,-4
1ecb5f93b3af6ab23cbf2eaa329fca7ae140f530,org.apache.tika.parser,9,3,50757,6
62428f2d6530e9d72f772bd163c010a3bd4f4eb9,org.apache.tika.parser,1,2,50756,-1
38697cbec28a90ed7b4726b081a82ecf98cd47fd,org.apache.tika.parser,57,23,50790,34
8045b054b612d9e4f8449e9c2ab1e4dcfd84214a,org.apache.tika.parser,16,0,50806,16
ef88dd920ab5e791beba6d361c147d95b10fffef,org.apache.tika.parser,1,1,50806,0
c7c166a559ba6ddffec746cc2df1d889dd0a8b11,org.apache.tika.parser,355,0,51161,355
8bb18b1d29259578c103c11154b005e74a1c7a11,org.apache.tika.parser,14,3,51172,11
99aaf119e4af3836c4edcbebfc3ccf497f5dd16f,org.apache.tika.parser,0,366,50806,-366
98b088d6f1cdd44aacabc60346b8b065ae2eb94e,org.apache.tika.parser,2,3,50805,-1
1139986b6bfb1f00ab7eab03adb9a95862a37fa2,org.apache.tika.parser,1126,0,51931,1126
b4f1c29ac3c044e9732bbf1c39c50a3ad19f608e,org.apache.tika.parser,1,1,51931,0
a47881f5f185263ba518e71243ba63bb5cb2de8a,org.apache.tika.parser,8,8,51931,0
3e9ccb1f97b6708d315ccf0e0fbdae969782b072,org.apache.tika.parser,25,13,51943,12
f4bdbbe73dad9e7b979c4bdabc6312bb2ca0d57c,org.apache.tika.parser,4,2,51945,2
f71910e2e00b55fbfd339e6d682521f64de0c696,org.apache.tika.parser,3,2,51946,1
19eb4448304abff6322d830ccee7ed868d443d71,org.apache.tika.parser,157,138,51965,19
d5981c7079c23c58dbb91aebce30de5498f51b8a,org.apache.tika.parser,97,82,51980,15
2d55f1d8e549911a296420844b62b4348fae5357,org.apache.tika.parser,6,17,51969,-11
e349b4fb6cdb37b5dc2e7c2344a038d392e29c79,org.apache.tika.parser,114,5,52078,109
a406151ffd02141a8db8bc9faae97d98b5306470,org.apache.tika.parser,1,0,52079,1
fe421fd83a1b79b81e61aafe09b1a184ebc1bdf0,org.apache.tika.parser,5,7,52077,-2
8938fdfa93f8c0647e547e8a04a187fbb5a32603,org.apache.tika.parser,580,1046,51611,-466
3f99f456c61ce3f3e3a368a6a08beaf0172bb270,org.apache.tika.parser,1,1,51611,0
191c03d14e33606ffd4bef2972704398abce289b,org.apache.tika.parser,26,5,51632,21
36c2ea4d27bb63b59d5666f607409e644b685c42,org.apache.tika.parser,44,38,51638,6
5d50c2e9391a9f31ea435724aef9e0bb73624984,org.apache.tika.parser,1,1,51638,0
0c86583772df742140c034dee789b20585cdbebb,org.apache.tika.parser,22,0,51660,22
6f6a76450cb36d9370fb2f3f3c5893b01da0d56e,org.apache.tika.parser,14,0,51674,14
2e60efbfc81132cb46e5d6edd2e0dde28881aadf,org.apache.tika.parser,4,11,51667,-7
a960709593b0a88286e3aa3d1e71888f99ce1b85,org.apache.tika.parser,8,2,51673,6
9e9ea27a665506579b329c66bff9934de19e6128,org.apache.tika.parser,3,3,51673,0
c2895d525a941e22dff4e8a757d4025ce8f6e719,org.apache.tika.parser,78,45,51706,33
58df156bbe4ccfca5d5a7a50651c5259078075de,org.apache.tika.parser,135,135,51706,0
02bcf2097e14a70274abbc1f9703548b82458f41,org.apache.tika.parser,10,11,51705,-1
6750a059caa2ccf6cdc55ee78dbec411cd084d67,org.apache.tika.parser,111,119,51697,-8
f682eeec632bcfba9c879de077a968b926c3fc31,org.apache.tika.parser,2,1,51698,1
702b6c4d7b2b15bc2adf82b76df27511c9af3d87,org.apache.tika.parser,1114,0,52812,1114
a147d7c0b5808f7e8732898e907274abedb8c486,org.apache.tika.parser,232,0,53044,232
ded52941529d2303e9278f583e7221ecaa7ec19e,org.apache.tika.parser,282,80,53246,202
3574c9c68d8620db9b89e294daa34267f2a09712,org.apache.tika.parser,26,1,53271,25
caa2b5a675f71b2c66eea3a2216dfc1621710dd5,org.apache.tika.parser,10,9,53272,1
61671f5d97d97e6f379dd94391ed8449f8c15073,org.apache.tika.parser,5,5,53272,0
40b4a6d988f3745e530d6c9f703f14771eb0a326,org.apache.tika.parser,30,9,53293,21
489ab93c70227da902774badcca54ebb8eeae533,org.apache.tika.parser,22,11,53304,11
6ef9c948f30b5ad5ee64e8b40439b98f8072f8fd,org.apache.tika.parser,2,6,53300,-4
d685742c6e81b9153ce881f9622292104a4144d2,org.apache.tika.parser,201,0,53501,201
2b99eeab8bb4c8aaaf13202904910298dc446c05,org.apache.tika.parser,2,6,53497,-4
db2b475733dffca63143551a5f1ddd89d97f0960,org.apache.tika.parser,8,10,53495,-2
59ddcaac5f479b4485d35c061e81dfa612773aab,org.apache.tika.parser,0,3,53492,-3
892beca8b7c76c7849e9a71a0e252fca606753af,org.apache.tika.parser,16,0,53508,16
fabeac95b56b0f430593881b705d9c57842f04a5,org.apache.tika.parser,5,4,53509,1
1e0159b733dc7a8f48ce8943e1f15046c791349a,org.apache.tika.parser,1,1,53509,0
6c0b7906ecbc22ea9adb4c1e5781b0eff561957d,org.apache.tika.parser,6,5,53510,1
14ca32045361918f5dd28c63c9692accbcfa31d5,org.apache.tika.parser,18,25,53503,-7
28b9a6667c6618f9f326f715588515aaa3f6eb89,org.apache.tika.parser,7,0,53510,7
1b14b39d3e1b453620b2f7b26a933103a78c958a,org.apache.tika.parser,1,1,53510,0
f054bcd1a0a57a730ebc53e7a2cfd4215a7526fb,org.apache.tika.parser,13,5,53518,8
ac4c0b2c9321bba395b92214a3504d8346c3e936,org.apache.tika.parser,55,41,53532,14
a13369b098bea09421e35023c131adc092dcb6e4,org.apache.tika.parser,2,11,53523,-9
7ebe007ec03088449f67619ef1e6cb564178b14b,org.apache.tika.parser,0,2,53521,-2
c809690ec87ffa600018dbc5eee6d6756645adb0,org.apache.tika.parser,207,0,53728,207
cdb684d9c1b0ebb01a783180f07417760fa04d6f,org.apache.tika.parser,2,2,53728,0
0dbd69cef5ec603a11d7f5b52f119e3bea1550b5,org.apache.tika.parser,11,7,53732,4
dbefe9830b26d05f9ce53503565a069bcc63d7c1,org.apache.tika.parser,440,4,54168,436
9056894da580107d1a5a21b29a0b7042ffa15c42,org.apache.tika.parser,440,4,54604,436
c5d4ec6c50824a9a40fdd2b492bf7557d8d693f3,org.apache.tika.parser,199,29,54774,170
b2cf23178ede925b0ef23f88ebf1aff95c8c157c,org.apache.tika.parser,202,2,54974,200
bf2d405437d5807525406e26025e12d445e00b20,org.apache.tika.parser,8,6,54976,2
64db9614cfaa3e873a9dc9efc6d201d887f6a4c5,org.apache.tika.parser,14,1,54989,13
0d69ca7540b4350e043c5b9ed34d14a46bd70cf7,org.apache.tika.parser,2,9,54982,-7
73aaa1bcee194e8fa73cb0c3cd60ae2eb3205bf9,org.apache.tika.parser,7,1,54988,6
6a8bb0dfda6831a96822257ccfdedfecb458f393,org.apache.tika.parser,13,11,54990,2
1924c3f3fb56392ffba2118b437fde0a9be3a3d8,org.apache.tika.parser,7,1,54996,6
98eb56ec78f2e1d27de644f4f6647ea1cfbc930b,org.apache.tika.parser,134,320,54810,-186
9ebf066dd96783c952f4c2a37a2a02af2b0c5aa0,org.apache.tika.parser,3,2,54811,1
30e4e614ef7342ae114944264d7b487803e7e1a9,org.apache.tika.parser,22,1,54832,21
63bb15467fcd6e8766b0361e78231f6f7f6a4a08,org.apache.tika.parser,6,1,54837,5
5e170d4373c28a4b520196591c4d94ab8073bfbf,org.apache.tika.parser,49,23,54863,26
4f22b085b1569d66d711b79751478dfb8448c353,org.apache.tika.parser,103,78,54888,25
5a74addc0ded0120949fc330564986607f6d8b39,org.apache.tika.parser,1,1,54888,0
6a3aa1a713a990539e58f68b4c902f9f93d5372e,org.apache.tika.parser,64,26,54926,38
1c854185af6ad5668127b69a459fff2f45188774,org.apache.tika.parser,1,1,54926,0
e0005b37458d6fdd477a4cf7d95fb9234e7b8108,org.apache.tika.parser,9,7,54928,2
7a4301ed3ac21f73b049d4111f46ba6cda69145c,org.apache.tika.parser,33,42,54919,-9
27f1b8f726d7757c4aa57a0e3ae07d3e22cdfba7,org.apache.tika.parser,16,12,54923,4
e2ef2e9aba5783d205e428a3e607cafdb3ce102e,org.apache.tika.parser,8,2,54929,6
ca1c265bb0c2084e0a736659c5fe1872acf9008d,org.apache.tika.parser,3,2,54930,1
cffda850a1ff23836195da25416712f815136354,org.apache.tika.parser,16,32,54914,-16
d6923907d78cdc4bd05f0d67d88b9fb2bb162002,org.apache.tika.parser,19,11,54922,8
f89a19ffced973f212a7f28e8eed3b17f2b75d69,org.apache.tika.parser,32,22,54932,10
71f8423b0403955265a0726ff3173cc5708518c4,org.apache.tika.parser,141,294,54779,-153
270b8a966c2a0d68d92d1776c4b57f2137adc2b5,org.apache.tika.parser,5,23,54761,-18
7e2c089c8e3f01fd60473517f64ed20887584527,org.apache.tika.parser,306,0,55067,306
5f859fbb7684a907db14959a4e49dfa644ba93d6,org.apache.tika.parser,166,0,55233,166
2210c81ac8111f45f054bee5552a3f4f020eb000,org.apache.tika.parser,4,4,55233,0
ab09b0c6b3fc76f414dcaa464a2dbb58f52e0875,org.apache.tika.parser,12,14,55231,-2
f9a716a4db4e90145384520a779e43560a01de6f,org.apache.tika.parser,9,2,55238,7
b5e246f9a71a3c1ffcdf4a82ad50fc5b03cf83ae,org.apache.tika.parser,1,1,55238,0
b4404c33f641d14507c5a13cc0b0f5e7c2cffab1,org.apache.tika.parser,125,8,55355,117
3d491317c8c67ce9f159b531ea476e547e0dff83,org.apache.tika.parser,178,47,55486,131
172c58443550d256a94994aba24c6600a2397256,org.apache.tika.parser,41,84,55443,-43
da1fe243ace68cc2b5c4bde022113233ad95ea15,org.apache.tika.parser,832,682,55593,150
2e0c9bdc83af8659c01848886bdfc80e055a5f2a,org.apache.tika.parser,3,0,55596,3
1e2bd89e73888ed293d820d2bf33fb56a5402ce7,org.apache.tika.parser,17,0,55613,17
483c162602e6bffa61fb9d096f56d292405f4a07,org.apache.tika.parser,6,2,55617,4
9f3a32a171d2f45b057bb1f7bf8be5c28daa45d9,org.apache.tika.parser,5,0,55622,5
443ecd352deae04f650b2e3dddb534bb19734806,org.apache.tika.parser,25,0,55647,25
72d76f884e3997ecee322e8327f51053d0a34bad,org.apache.tika.parser,32,32,55647,0
2ec36ff4b817d1378b75f0654648a260c3d5928f,org.apache.tika.parser,163,178,55632,-15
f39c087ea36c074acd3cca8de702b2860bee7096,org.apache.tika.parser,19,29,55622,-10
80b27e6d843d221de87591d34632e546c0d23b1a,org.apache.tika.parser,540,321,55841,219
2cce66ddde6f44c258418bc5a057ba58e6267098,org.apache.tika.parser,15,4,55852,11
c9d508dc184244bdc08657e7da2f33b9a1fd6bd2,org.apache.tika.parser,48,43,55857,5
e558f5da8c9bb27eecc4ffe3d05a009698302d98,org.apache.tika.parser,8,8,55857,0
a484e5ec5a275219ac947b95c8b3df1fcc9a89fd,org.apache.tika.parser,40,113,55784,-73
2caf3da7cfeca675530fa86c6f76c451a433e732,org.apache.tika.parser,271,241,55814,30
b5fe00efc78821d6e5c487fe439dba3c733563f2,org.apache.tika.parser,6,2,55818,4
cd0676268256e48c7d8ace07c00cb105b6dcd754,org.apache.tika.parser,1,1,55818,0
5a8e269017091a76ccc65e9ba0aa5a3b072b60ac,org.apache.tika.parser,43,116,55745,-73
a30b143e41857be010149e01c5fb0df363157e6b,org.apache.tika.parser,6,1,55750,5
eb51d9b05cf69e1c4091ac022a4f84e6f2ba23b6,org.apache.tika.parser,233,0,55983,233
9ecb183515779e6db631b817672673f219461a52,org.apache.tika.parser,12,7,55988,5
d711ac947169db589dc601c11bf53a435385832e,org.apache.tika.parser,160,0,56148,160
d0c52590ce0fff35c143138d71439fb56c3c2de4,org.apache.tika.parser,1,0,56149,1
ab7c3253b8450c2d483edab60e4365fef0c4ae38,org.apache.tika.parser,89,41,56197,48
0cdf17df913cadf23c8074d46d386fa230f8198c,org.apache.tika.parser,358,0,56555,358
7a543c8076a3ceb2dfa92fce06fc558cfe84cde7,org.apache.tika.parser,212,187,56580,25
92a4835d02d94fddbc7d70c0507b8a32345662d9,org.apache.tika.parser,3,0,56583,3
b6d23c189e852fa2e41b441c18bfe3e66e3f67c4,org.apache.tika.parser,41,0,56624,41
6a1991896d05573ee998d1077671990553e2c0c2,org.apache.tika.parser,72,70,56626,2
9f09a558648bf2d8b17c611498e097db0513fb7d,org.apache.tika.parser,5,10,56621,-5
e2e10f9ac76bd0566a33dae71a666bb2f7746f24,org.apache.tika.parser,8,1,56628,7
eb05d04eb29c8ba783e509a438b10e2183b222c7,org.apache.tika.parser,2,1,56629,1
585ab9b93d5b197db67ac736c2ea0429547f91c3,org.apache.tika.parser,358,0,56987,358
7f486e693bb28448811245e71deeb3fb561332b2,org.apache.tika.parser,3,9,56981,-6
4aff4839aece41a739b93169cf7a475ecfc5c70c,org.apache.tika.parser,429,80,57330,349
8e4c3ff0a37fa7a64f5f675ffb7c0f7a8322cfc4,org.apache.tika.parser,10,2,57338,8
ff066dd5aeda0a54342be3dcacfc542479061e6e,org.apache.tika.parser,16,0,57354,16
46d5775cd42e8c6c378f2100c70aca18c3f37df4,org.apache.tika.parser,41,0,57395,41
c1a3ce0ee108d865beaa765bd169fa9b463135a2,org.apache.tika.parser,419,2,57812,417
e08d00654a77267686a112e0665c324ef041c033,org.apache.tika.parser,11,0,57823,11
09cc658a30ae194323f1e444be73d396544efc6b,org.apache.tika.parser,76,1,57898,75
89881ce207444a9d53f041bf9a14b5b7d623dca6,org.apache.tika.parser,15,7,57906,8
4a324ff94e148dd918538559fccb575bace80a9f,org.apache.tika.parser,2,1,57907,1
534347d0f095bd89409140db00927a532fb53213,org.apache.tika.parser,126,3,58030,123
6e4206215b5adad8f660b870de93c3d3c2ed7c6d,org.apache.tika.parser,2,1,58031,1
9024f12e0fbef206330b6317a537354fafbe9cd7,org.apache.tika.parser,32,0,58063,32
e780d56652d48dd0f50b4e62a58153e95f055022,org.apache.tika.parser,2646,1527,59182,1119
b64612dcdb021fbb8b3fbf31d70a02f1bb7736cb,org.apache.tika.parser,5,2,59185,3
fc4f13ddebf2b9519d75a3079adb307313e79259,org.apache.tika.parser,9,5,59189,4
e74f66375f20d914f8585597b6d9492586a0caa9,org.apache.tika.parser,884,0,60073,884
167966e46db0c2f79fc7b425bcec964590c29159,org.apache.tika.parser,9,5,60077,4
608fbf580addfe106f7ac392a067be23c455f07b,org.apache.tika.parser,95,20,60152,75
b47f162a595e3d776391fab24dcaa75de2892f1d,org.apache.tika.parser,1,1,60152,0
01869923533b330ec7728995e3ee5feceee1b90e,org.apache.tika.parser,9,6,60155,3
9e08a6bc0a2b2ffad12e4b6f90725b2201d0a69b,org.apache.tika.parser,35,1,60189,34
dcaeccbab69519811e0cdf349873ce2b51e6ca10,org.apache.tika.parser,54,44,60199,10
1a04f8056f0140a34641435f4aff21443efa7bbd,org.apache.tika.parser,3,2,60200,1
16290d86c3a976f7c323b0be6750ad07f4840018,org.apache.tika.parser,36,2,60234,34
c6eefbde650dd3be88103416b45ca5e92a336f92,org.apache.tika.parser,3,2,60235,1
6ad18f44cdfef5e80b343d9c06787b850fcfc9fd,org.apache.tika.parser,26,3,60258,23
aad23d9e848b8d8e9a5a7a1f4359ef4a2dbdba24,org.apache.tika.parser,164,0,60422,164
40f8ec95b1c1c2e1713d26e0780b3bd2f97c9bb1,org.apache.tika.parser,5,4,60423,1
3ca9214cfda576ffd7aba2b1216fd36733266837,org.apache.tika.parser,2,2,60423,0
fbd766e254a950e4a224408853658e983c0a4788,org.apache.tika.parser,0,1,60422,-1
a20c46cc71e7a83a5c5cb4256f5c6a753b901a90,org.apache.tika.parser,4,5,60421,-1
ea47b716e5a7a1a1637b1cef0dc439b140590711,org.apache.tika.parser,1048,18,61451,1030
7aeb95d6c7a6ac3611f2dd975baa73f566631061,org.apache.tika.parser,1029,582,61898,447
49ddf6e39615e8284a7c9e45e76a659725c0ad7a,org.apache.tika.parser,413,1,62310,412
18ab8f91f19b105270a107174afd64fe81d20f72,org.apache.tika.parser,127,68,62369,59
853750d47fa99afad0df6d4f4727a35c96675254,org.apache.tika.parser,55,6,62418,49
3e14505381eefa603adabe61171c0c19fc685b2f,org.apache.tika.parser,59,1,62476,58
99aa587d171207c0c557ce65397f767d6a42cdfd,org.apache.tika.parser,2,3,62475,-1
71726bc1faafcfd955a99c38e20784dd5de61f89,org.apache.tika.parser,9,0,62484,9
9b5dc7fae4456b12b75ec21d050b9439e6527c47,org.apache.tika.parser,76,9,62551,67
2184e2c2c2a0e507be6be4f9692e0fab5b38a476,org.apache.tika.parser,609,0,63160,609
0305cfb402f5d5e289533411d5737e1e832888ac,org.apache.tika.parser,2,1,63161,1
f3e9d82865f141ef990d3f2ddc93af9be52c829f,org.apache.tika.parser,11,6,63166,5
6b56ad12cd16e23de90205f47f5ef18ed36c333f,org.apache.tika.parser,212,0,63378,212
2a61205402c90fa49fbd4ee11c48cf7473aee07a,org.apache.tika.parser,25,24,63379,1
ecdc403578d2a2b8fb70f66b7df1ece96b5efa9c,org.apache.tika.parser,58,1,63436,57
338db905d4e203d4df4582d5511242eaa922af6b,org.apache.tika.parser,66,52,63450,14
2140858840af8f1c015f3570dc4ac8d2bb4405cf,org.apache.tika.parser,9,0,63459,9
03d38248f37cca988866484ea759224f865c7765,org.apache.tika.parser,13,48,63424,-35
01320372fdbfc5e4ff0cfe0fe85fab91b5b369e7,org.apache.tika.parser,115,9,63530,106
30b0f6674450f9aab4bacb5ab071ae96f4835c63,org.apache.tika.parser,118,112,63536,6
f8fe50a2239cc8875fe3df7de6215e40da48b587,org.apache.tika.parser,5,146,63395,-141
027625dd71fe9f5c33a546b7395aee744adb2ae0,org.apache.tika.parser,239,201,63433,38
31cf12d51539c1ec01c12d73f96e7eadfd2339f0,org.apache.tika.parser,20,13,63440,7
5101023503c892d4af49d33c85a13b99f85bc0b9,org.apache.tika.parser,7,1,63446,6
d6981ad81334eb20174004d7c0d96acd9f1d2f12,org.apache.tika.parser,98,0,63544,98
48b27d219f791ee14f1e0ffa18e4e80583f3df54,org.apache.tika.parser,347,4,63887,343
de84d71b145045792b8a3bd175634251623188dc,org.apache.tika.parser,13,13,63887,0
be8b433d2994af4e0d95de3bc5ab4fea99ee6bcd,org.apache.tika.parser,160,0,64047,160
0f3b0bdb5b78177e9f0fca88f889e7919823c177,org.apache.tika.parser,251,0,64298,251
e6c2839c0a77db90c52e7cf5c3841d09e8cce3b3,org.apache.tika.parser,2,2,64298,0
c1cea20efb5ed28cfd3fe889120d7ddbef9966a8,org.apache.tika.parser,21,38,64281,-17
b10f2506939a1c62648e2dd7b1094e42f840541a,org.apache.tika.parser,21,1,64301,20
37695d4723f687c57908eccd8d4e56fe90aab634,org.apache.tika.parser,70,2,64369,68
2c4670e534bcc3535601de8a069e7708961ae269,org.apache.tika.parser,19,20,64368,-1
b6d55ae345db933d69cc9a7d290e3f8ca567b5a9,org.apache.tika.parser,71,90,64349,-19
69d825005fccb94b7ee453fab002eb6e6c734dbc,org.apache.tika.parser,1,6,64344,-5
23a11eff3018977f031cce663bb412678f08ba89,org.apache.tika.parser,10,10,64344,0
bc6667c195bbef1a672fd635ff7e253143ba2ad8,org.apache.tika.parser,11,11,64344,0
6773d42de77230dff621a1010ed37f0505dfa302,org.apache.tika.parser,27,18,64353,9
fe559b80bcad1f107904ca7a89724a26ea2921a1,org.apache.tika.parser,2859,728,66484,2131
27e999df0e2c44f2ec988e23c5430d2b4dccd053,org.apache.tika.parser,3,2,66485,1
c2a8ac1eabf6bb2a2e25e0715fe3a7adef715816,org.apache.tika.parser,19,21,66483,-2
68092824850b8dacb69874aeb8275f8a62cc2526,org.apache.tika.parser,6,6,66483,0
1a46c590cb0e0fbaccd6f9793c307fa6458acd16,org.apache.tika.parser,6,3,66486,3
95b2cd127346486cece4cb1450f444fd9bd54337,org.apache.tika.parser,7,2,66491,5
b3c09b47d2c16056eed57ca79f85f6df568425bb,org.apache.tika.parser,2,2,66491,0
4fd3e6825e6794a9846bea7c73d46a389197b28f,org.apache.tika.parser,1,1,66491,0
1c6cff83626f994e32beae8dce6f17ddf29cc45c,org.apache.tika.parser,450,8,66933,442
6f16480f7b1c6b9677626f215f52505d4b61a31a,org.apache.tika.parser,3,3,66933,0
c0320f14194608d31b9ffaae9250f28c46017b75,org.apache.tika.parser,3,0,66936,3
8d29f7a625e932fe31d0611e894f4f1c485457c4,org.apache.tika.parser,450,8,67378,442
952fb54ed78a2fba07db4653cc674f5641211031,org.apache.tika.parser,74,8,67444,66
9e0a87e68a0a6b45a2f740a58b0db99d9eeecb4a,org.apache.tika.parser,764,12,68196,752
3deea1b7262f772e7b084a32b78f4005811f89a6,org.apache.tika.parser,4,2,68198,2
7dc5c671f892bac79d8fb2d55e9e94718ca31cbe,org.apache.tika.parser,105,2,68301,103
71cb9363c07839e68712edde4626d53aa928cc2a,org.apache.tika.parser,32,13,68320,19
e5398027328f25b9f968e0009d8a1164e1c894b9,org.apache.tika.parser,4,4,68320,0
8a68b5d474205cc91cbbb610d4a1c05af57f0610,org.apache.tika.parser,5,0,68325,5
5495ffcf35bb702d6cdb28b4fa3bdc7df34e55e9,org.apache.tika.parser,6,5,68326,1
f77eb2b5ab4e09208b77d3d860e6520151d20653,org.apache.tika.parser,1,203,68124,-202
a1d1a81d15b287b44041d590d8b124be06af0a19,org.apache.tika.parser,0,10,68114,-10
0096dd78c93840091537ed9324d24d2e9c5b9f28,org.apache.tika.parser,3,0,68117,3
52be42599bf406c9cc5ae16f539f2b57d4000af8,org.apache.tika.parser,35,16,68136,19
afb7e3643a61e9dc6c4921b12bc145b1be4e1402,org.apache.tika.parser,2019,58,70097,1961
bf072bb25d30ea74d5c699d1e4a0036fb109a2bd,org.apache.tika.parser,4,4,70097,0
5e4678ef6940f63e21b23aec2fd98bcb1b56d395,org.apache.tika.parser,4,7,70094,-3
bec2f9b7b8d787d4bbab4e33d55e9639d8f21039,org.apache.tika.parser,0,1,70093,-1
084379cf509746126bfd630945edc16e0d96fcfa,org.apache.tika.parser,0,1,70092,-1
d50a69361bd0196fb2595313cb47222f61701ba4,org.apache.tika.parser,2728,92,72728,2636
10507d0521a0f06c50f32aa6150228ef4ac773d4,org.apache.tika.parser,48,11,72765,37
3a5431e200056d85b458bea766fd185225771c97,org.apache.tika.parser,137,30,72872,107
ce07d8a10499fae015f07ca4fd4daf3473ca5193,org.apache.tika.parser,43,12,72903,31
308d26fb297c6248f98d777b7a94192fc0ecfce2,org.apache.tika.parser,3,1,72905,2
c33ac04618f97c06fe4508b5d41465b2c11ba1b9,org.apache.tika.parser,13,5,72913,8
0a4b0e80bad54e88c1f76cf8f37810757b1b34c9,org.apache.tika.parser,13,5,72921,8
9b497d1fef2fe183b2099f1a835113dade8a0227,org.apache.tika.parser,11,5,72927,6
5af482ef6341369d6ba30df87ca2c8be9f0d0c0f,org.apache.tika.parser,2,1,72928,1
bfd1d9139b33db44695fbcbc704159b88c7a7c40,org.apache.tika.parser,2,3,72927,-1
8e819c3caf3ff3b0492f600b4193d1b3ee74f51b,org.apache.tika.parser,6,0,72933,6
02425b290ce5ba2adbbc3951c7f04c8435692696,org.apache.tika.parser,197,57,73073,140
a6b8e0451c035fc8ac86dc99497868e4ea931d15,org.apache.tika.parser,0,1,73072,-1
7fbf0f304d8e20f7e26baadee1f85974b03dee8e,org.apache.tika.parser,157,17,73212,140
4dd6fd11035c09070689471975cc661aafa77333,org.apache.tika.parser,146,77,73281,69
b67373f22bb84d9e40019836817784faaff61ec8,org.apache.tika.parser,2,2,73281,0
011f33807e7e794c2c06154774ec167b818930f2,org.apache.tika.parser,1,0,73282,1
15a92302501d5ee6a319442c8109eafe37ec4595,org.apache.tika.parser,7,10,73279,-3
2df68c84b043f3158c0bdfa63d1a0c8d44d7e18a,org.apache.tika.parser,2,2,73279,0
aadccbf9719531ee1ddfff19c5e85c433d6930cc,org.apache.tika.parser,3,1,73281,2
7b45c7ceb0830cb33a04571da87dd86a817d4138,org.apache.tika.parser,16,1,73296,15
7dda921de92c5ded7b62f431247bb2d7e8f06d45,org.apache.tika.parser,109,4,73401,105
c17d1b8a6bef4409787aa2b58b96f691dfcf1170,org.apache.tika.parser,3,2,73402,1
47ba703d6e682147fa3e6abb9a9cc756c7fc2760,org.apache.tika.parser,120,222,73300,-102
91cdce43d22cd6726375a83c7842fa299035a258,org.apache.tika.parser,22,4,73318,18
1aff6380d46b9104835909c31e7f2f36f621eca0,org.apache.tika.parser,3,1,73320,2
98de2882842cecdf5d160c76c3b1f1e62c57d563,org.apache.tika.parser,1,1,73320,0
b97045aea303bac75bd3c937cde6b42c7a3b3c48,org.apache.tika.parser,2,2,73320,0
2df8567ffc688a29de1394a208e651961a8ab53a,org.apache.tika.parser,40,22,73338,18
361ffa40a5cee9f37d01f40c2074a18b04c4a6fb,org.apache.tika.parser,7,4,73341,3
0e0f30d9bb7352bf08c884f8646619ca215a6907,org.apache.tika.parser,232,43,73530,189
99b59243756d08124497686642d559f31d549543,org.apache.tika.parser,15,19,73526,-4
40401e51b8a135634f54c8c437dafc10378059be,org.apache.tika.parser,1,1,73526,0
85c345723f68ff67091e7a4a6d0c8f25ccf47fe6,org.apache.tika.parser,5,0,73531,5
8e12ebea4178048373c3c946eb159d6f68baa4e9,org.apache.tika.parser,1,1,73531,0
c83f87b2acc6a8fb69dc37991d43542367154c1a,org.apache.tika.parser,415,393,73553,22
87c2ef3191d0a86502dc249240022b3cc973aaa4,org.apache.tika.parser,1661,0,75214,1661
ae44b9e507dbb11b9b9f5c57cf342b47966ffb66,org.apache.tika.parser,68,3,75279,65
aa2407a6ba9826684df81af60c58b476e193a830,org.apache.tika.parser,1,0,75280,1
0de63a16686e88245f40bd2da65e8b0274889e4d,org.apache.tika.parser,3,3,75280,0
202f137b7bd29f75d95ea815a28df30ab4f144da,org.apache.tika.parser,69,64,75285,5
7a5b98319dadd8fcb2913ee9bc6f98787105db13,org.apache.tika.parser,1661,0,76946,1661
d011d708c21669759af86e855b61d98dae19492e,org.apache.tika.parser,220,79,77087,141
aa448a3b7e61f9a46efd1bf3f2ac72e6a3852d8f,org.apache.tika.parser,1730,64,78753,1666
84a37209e1c6e27491c9e828799919bc32f8787e,org.apache.tika.parser,71,31,78793,40
6dc442da50dbb22bbf2b73076d5080f32af03067,org.apache.tika.parser,660,305,79148,355
940e6f483ec87725870b3c9d62ed0b2ab9a5811e,org.apache.tika.parser,53,23,79178,30
e6cbaa03be9e362c6572f6cde351e777abd4c763,org.apache.tika.parser,78,11,79245,67
09632ef9abb697644ab606d56f56531d5cd81058,org.apache.tika.parser,7,3,79249,4
11fe4ba37fa295f284c1c4ba78b2e5ac836d0215,org.apache.tika.parser,30,19,79260,11
9fdf9a83324ead9b86e09318735852dc6e3f527c,org.apache.tika.parser,93,11,79342,82
86dbde4ec93d4dc962d99349d23f08c326e607a3,org.apache.tika.parser,4,14,79332,-10
66f6310eec8e8aade078f0ca32a07399008ef1b1,org.apache.tika.parser,5,8,79329,-3
d1b1ad3d916a413e8fec20b5f68d20fa9b2c4ab6,org.apache.tika.parser,2,2,79329,0
ba26f6ee01574702f5eaa56bf45aaf06e043d6df,org.apache.tika.parser,18,1,79346,17
8eb7d352f6b7a488bfdca172a0707cb514157a34,org.apache.tika.parser,88,39,79395,49
25aa2bec2278aa94b24f3d4abca6c076221308af,org.apache.tika.parser,20,9,79406,11
5c51534a5731dba0ed22bc04b7da9d95adfb6f50,org.apache.tika.parser,32,7,79431,25
8a04f207e8c4e2a87e61930e0e28be48ce99d20c,org.apache.tika.parser,131,56,79506,75
02eae6d5c03d2ed1b23273536c92ea6c40648579,org.apache.tika.parser,32,7,79531,25
9d97e16e594f27dc850de6cdf3831c7a61454d57,org.apache.tika.parser,6,1,79536,5
896c46a0c652de436da0e4f25bfa53a7d83ae02f,org.apache.tika.parser,10,5,79541,5
9477d03e10149a8ec6b5d6889e2fd2317d2ed5f5,org.apache.tika.parser,169,64,79646,105
4cc15e2a3f813dce8001c1eb4aae712b05c557d4,org.apache.tika.parser,19,24,79641,-5
847156ac0f5fa7d4cc06964198359cf594b66d50,org.apache.tika.parser,12,12,79641,0
e6c0082e41143a01f0bf646a8a8b6c06a85ca239,org.apache.tika.parser,1,1,79641,0
90bf4f6e4c645240b36ded6973eb64961312fc0a,org.apache.tika.parser,2,2,79641,0
7afcfc702e3097f652a0ea21c368f7632d2abf3e,org.apache.tika.parser,15,15,79641,0
fe94908c052dd70fb9f1c3e369a3547b335d8760,org.apache.tika.parser,8,0,79649,8
7555b136d9ba046e2007d1f305f707948fcbcbc3,org.apache.tika.parser,33,19,79663,14
b9befb4272cf8b2bda3b3ea25b0511bbabfdeded,org.apache.tika.parser,20,20,79663,0
3366bc606de640b9f25ce58ffb9ba847b4ddb6f9,org.apache.tika.parser,3,1,79665,2
166ebb2b58478b3d48db551051a3ff2b66435166,org.apache.tika.parser,10,0,79675,10
1c873399ee30af9912a7210e4ced8168f659db04,org.apache.tika.parser,1,2,79674,-1
e86f2d8749e45b04731b6ef1c3c490ae624ea501,org.apache.tika.parser,0,9,79665,-9
bce5c795fc6dd49b6ec7a3efbc77c6e977e4f683,org.apache.tika.parser,2,2,79665,0
10ca360c229d82997540a629183c75def21bd31d,org.apache.tika.parser,4,4,79665,0
6e4116b4fc6b39a5716f4193b1b236eb357fce50,org.apache.tika.parser,10,3,79672,7
e3a50ba30ad5ccee721401ceb20464cb327de17c,org.apache.tika.parser,6,1,79677,5
6697dcdbc1fed64aa31c90a284d310ad80b72f20,org.apache.tika.parser,8,6,79679,2
6d022be03b5423f6c036e1aa45e4ce02a9678462,org.apache.tika.parser,134,36,79777,98
e7a0c3eece98ac81b3813aeb429b24f16090201c,org.apache.tika.parser,45,21,79801,24
5e0f926c57649e1abfe56fb893266a501f390f1c,org.apache.tika.parser,0,2,79799,-2
efc67b8e558a88ab9bd2790b6a894101746167f2,org.apache.tika.parser,23,5,79817,18
3c3e8e17e3016c5d729743ef40db6b00c1c2591f,org.apache.tika.parser,39,5,79851,34
4f10801b1dc910805a8d78da0d98128a2915fc90,org.apache.tika.parser,48,49,79850,-1
2234f3312f3ddca02f2899138157e1f5fdef92ba,org.apache.tika.parser,245,1,80094,244
fecb19a98f278166870b2aef4c9a5bc82a1f1a2c,org.apache.tika.parser,4,0,80098,4
3bfe830e5985ec3e8543d398e190c741ecbd5e7f,org.apache.tika.parser,9,0,80107,9
b2f3eafc49221cd099f0ad9126cf90ad5535bdaf,org.apache.tika.parser,48,20,80135,28
abfc826959a099d6000365ccdec23925f041043f,org.apache.tika.parser,59,10,80184,49
65182ee39b4fcbea0ec4d96a651194b9751b6c9b,org.apache.tika.parser,36,0,80220,36
e9ff4c023ba3f0ad913ac32af04cddde25bb914c,org.apache.tika.parser,38,7,80251,31
1725007a9ef7c8ae2111ee5e1433d4b908db7bba,org.apache.tika.parser,1,17,80235,-16
679e460368ef21aa23fabda61f53673c32ed6ed7,org.apache.tika.parser,38,7,80266,31
22f6ccfe09c89c59510a710b2b3560c92a53f334,org.apache.tika.parser,20,5,80281,15
7894819f44ff93c5fc115649d6befb196699f49a,org.apache.tika.parser,2,4,80279,-2
a9145d85afb6db5f99df70d6634caf9315ce7346,org.apache.tika.parser,10,4,80285,6
e8ee4ce7fbdc4fd8d0a496731f2b0a481687b72f,org.apache.tika.parser,64,83,80266,-19
6ff825c684236a6e1c8a4f77cbcd2d7fb953870e,org.apache.tika.parser,30,44,80252,-14
f55b87fc5cb91a9e9ee067e3c1c68dff691d48a5,org.apache.tika.parser,34,4,80282,30
c4660b4f7debf7870742ba4e1da296c20dca1292,org.apache.tika.parser,2,1,80283,1
58e18463c050574198944c909a97eeccd8fb48d7,org.apache.tika.parser,1,1,80283,0
0d8f030f02830a39e004fbfbd6989128ec2047d7,org.apache.tika.parser,94,127,80250,-33
f777f21b47c8d122e6b7a0819b44977f1d571c59,org.apache.tika.parser,165,0,80415,165
236db96393d94756dbc2e3f40b318f8f93b95dff,org.apache.tika.parser,128,116,80427,12
0c0bd4bec2312355d2bc48426f8ec94306d0e4a0,org.apache.tika.parser,24,10,80441,14
cb8f8f5e7ea2b4e13853e6dfc2165127521d9c64,org.apache.tika.parser,1,1,80441,0
c7f27b561ac1a44a35d3f7fd7881daf5dae8b835,org.apache.tika.parser,153,109,80485,44
1fc82e84cc27f60cc64c7844e36bdab2d3c85e7c,org.apache.tika.parser,2,1,80486,1
900e4cfff9c5036bceba6a2f6cda1a9c942d3fa7,org.apache.tika.parser,5,4,80487,1
0341a5d25dececf799746d6906963496a5256f11,org.apache.tika.parser,1,1,80487,0
b9f496c68b27e64f1eddca212db88e3444051cc5,org.apache.tika.parser,1,1,80487,0
f8c51bab139f0b7c8d9ea070ae40c87bbaf87689,org.apache.tika.parser,0,1,80486,-1
d199692b650edaaf743ca6cfc5c34954baf8831d,org.apache.tika.parser,0,9,80477,-9
0eedec8c62cf5e6ddee4f14ca4b4fa59d2930be5,org.apache.tika.parser,44,44,80477,0
03035d67156e3f2632e4ceef9158eae675f01734,org.apache.tika.parser,521,0,80998,521
09cb2df973f20e3a877ca1309b67384264650be0,org.apache.tika.parser,27,20,81005,7
f92809ac19d5bef903ef1ac393092e6a13884fc0,org.apache.tika.parser,1,1,81005,0
be773cacaf3c344c11fff9b85ebaf1d0dc8b5174,org.apache.tika.parser,3,3,81005,0
75a2ae12d170fc99b4bf9ab266c6169859c23dda,org.apache.tika.parser,3,2,81006,1
cc3496717e62f216139ef1b6ce7e6c5afa1246e4,org.apache.tika.parser,315,283,81038,32
653abaabbb7e78a51d15ef0b80f6e1a5c9f9cd85,org.apache.tika.parser,1,1,81038,0
7b2b27a1fd24a5d89b4f88f24a66c5797c8419af,org.apache.tika.parser,8,22,81024,-14
8ebe758277df372c14c5549d48535a6e9d5925dd,org.apache.tika.parser,8,22,81010,-14
8c9e02e76c17c9264b75eef04aabc6c7e4cc3642,org.apache.tika.parser,68,61,81017,7
0fb1458b7c14733785f03e23fa5c445bb3d5a2a5,org.apache.tika.parser,33,30,81020,3
6c903f25aa6508d06fc6f0044ac996ff9e9d9bf4,org.apache.tika.parser,427,2,81445,425
1efe2e9fc1abaaf14738d3c1cfe1a23fd6c58dca,org.apache.tika.parser,2,2,81445,0
3aab15f8f277614e3c5783c4862e25d63b737425,org.apache.tika.parser,59,6,81498,53
6205742a935ddd73093aa10a6601c14a259998a0,org.apache.tika.parser,374,272,81600,102
dbdead5c1ab375cc615a1db3254be0aac47e209b,org.apache.tika.parser,59,6,81653,53
1fa7fc46844d1a759abea0a94265cc4656ed880e,org.apache.tika.parser,0,9,81644,-9
84fb6fe419a921d12d3151a5705fdfac281c629f,org.apache.tika.parser,5,4,81645,1
a405fc40c6fd348b4d5cdcf77ec8143d261ab923,org.apache.tika.parser,206,0,81851,206
f1caef1cbf4093781121a85a6b3c5e7f58b15027,org.apache.tika.parser,16,0,81867,16
ae06bae9c81a83d1ad13db76e70625ba1c09dafa,org.apache.tika.parser,1,1,81867,0
db8c81410b8468e1a524ed2dbb28abc7154fb11d,org.apache.tika.parser,32,34,81865,-2
09698c67951c2bfe5dc0e0405ee9a718188a8533,org.apache.tika.parser,2,2,81865,0
d6b3ca4f74584b1912f9a6945ecd46d8fa14b303,org.apache.tika.parser,37,38,81864,-1
70343df578fa849562b9d38b9852ecb3b83baa0c,org.apache.tika.parser,4,2,81866,2
a970303966072be65a65ddf2809b47fdd0db27b6,org.apache.tika.parser,1,1,81866,0
0f1034aef7c7b3f76eea7242052f5f89ddf94dbd,org.apache.tika.parser,10,5,81871,5
75eea6e5502f4f5a2edf5ab459b4c369d33f66e5,org.apache.tika.parser,620,17,82474,603
9e89b442bd2b211c328eb563e42ed902f9e0ae6e,org.apache.tika.parser,83,8,82549,75
37d0f058c9a633a61346d9c04b22e4aa558fa634,org.apache.tika.parser,10,5,82554,5
a31ed0d995e16d67f510d0ffdaa1d890e1df2da1,org.apache.tika.parser,25,12,82567,13
77d57457b31ca0f3faa80fc293cd092dda7c9c40,org.apache.tika.parser,4,2,82569,2
834920e769e674b0af8024fdb6067ee12651d196,org.apache.tika.parser,1,2,82568,-1
dd515914e5b2986247834307eb7c922c3c2c50a9,org.apache.tika.parser,371,271,82668,100
4321f773b533bb920a21370a1334eff062d54c56,org.apache.tika.parser,4,4,82668,0
87a1b4ab0c2e0fe09c667ddcbce080d71085e787,org.apache.tika.parser,7,1,82674,6
e568bbcfaccdc56c8d917e47e4f6adcbdd46ccc2,org.apache.tika.parser,521,0,83195,521
a194bc4ba2b771807e93e664245f24e3573a15df,org.apache.tika.parser,706,18,83883,688
11ad0fd294fd4b673ecbed451c2057eae42a9f27,org.apache.tika.parser,12,0,83895,12
9b5662d855af296c287b42cc292dd1143c51ee85,org.apache.tika.parser,5,7,83893,-2
10529eba2bda73c577bedba3c053a01953911922,org.apache.tika.parser,1,1,83893,0
7c431b33bc40804cfb4591c890e442672071e39b,org.apache.tika.parser,58,0,83951,58
92a90c7f28ad0922313ed92bb276a56d314a7df9,org.apache.tika.parser,2,2,83951,0
91d18a65d862fb13cb25f9d062470f17b4d6bc82,org.apache.tika.parser,58,0,84009,58
d77fb59a54b40d1f850a89053bebd87409b2b05c,org.apache.tika.parser,718,18,84709,700
bbd4647a2d262d84edee2cc883d38e5249b47693,org.apache.tika.parser,7,4,84712,3
0cb3a19c80290aa6a5296b96b08988c01e63562c,org.apache.tika.parser,3,9,84706,-6
6a32d49c40f247bed089a6663e42255da8a9151c,org.apache.tika.parser,3,3,84706,0
ba009028c9fe54170b0917466df6d540942c5456,org.apache.tika.parser,1,1,84706,0
932a4a879c7221f212d173587c647c78f5858c52,org.apache.tika.parser,12,3,84715,9
434736be63373e8caa85fd8c9bd117e6edbec555,org.apache.tika.parser,23,5,84733,18
58a116c2123d9c01ba054969121244364059c0d2,org.apache.tika.parser,1,1,84733,0
310fa5413d50642c94647e86679c836a0f30c5ac,org.apache.tika.parser,24,9,84748,15
e141640891cd7adcfc1848b351c0db7eab00a2d2,org.apache.tika.parser,42,40,84750,2
49bb4691393c016d8d65e6b11febca9e56feedef,org.apache.tika.parser,520,3,85267,517
27f7b24b3ee2b8cc6974785c79a148c23c25b707,org.apache.tika.parser,18,21,85264,-3
04f150da6f51a53d5d64413b807aac99343f821a,org.apache.tika.parser,4,5,85263,-1
3462c9d2a4930ccb5efd8c78fc6a6bfa66093219,org.apache.tika.parser,1,1,85263,0
b0a4b95aebb215be4a8d4ac4ea55f5295bd2d076,org.apache.tika.parser,520,3,85780,517
197b9abb091bfc142bc4aa9df70182ae64d2d4f0,org.apache.tika.parser,2,1,85781,1
0ee2fe624e525ccbe544f4cf5cb49b5406147ca6,org.apache.tika.parser,1,0,85782,1
5df8780e938754f28d3e1280883993c6f234df74,org.apache.tika.parser,6,1,85787,5
0b37895ef0eae560444e3078b7fa33f6fec11eca,org.apache.tika.parser,14,10,85791,4
dbe8a03bd51a4dac547678d10601c701651d0c3a,org.apache.tika.parser,20,22,85789,-2
e7b0cadfeaf76bf6bd96ad35b3510633368a1a07,org.apache.tika.parser,66,6,85849,60
c5da6bbbddf877585a2869e4f3d963b3f7d62795,org.apache.tika.parser,12,0,85861,12
b46f20d41157a1d4b8d4cd2ced67fdf1f6772e47,org.apache.tika.parser,19,0,85880,19
70d2455c4ff7c54afe6762d5b50653b8de06f2b2,org.apache.tika.parser,2955,352,88483,2603
0d3eb1fd04b11e184252f6648453d86e90ed7e0a,org.apache.tika.parser,253,0,88736,253
3cc4bc2339ca02a1f6879d1a22bc7cd31411d566,org.apache.tika.parser,253,0,88989,253
e56e2b2915e8cebcf97c69cdcb3ecff861434f61,org.apache.tika.parser,14167,2038,101118,12129
414a4297a2000d8f9276e0ed5d657643f8e94d3a,org.apache.tika.parser,6,0,101124,6
0aaa1215fd11632c349e9bdebac9829578276cb1,org.apache.tika.parser,3,3,101124,0
906858434d9784e893bac24c63c1b15ea35fd3c1,org.apache.tika.parser,45,0,101169,45
c7719fbde6c83f7c9eb949a51bad43c69802533f,org.apache.tika.parser,840,0,102009,840
25fde023fcbb307aa83150e2e57554b62ac92a6d,org.apache.tika.parser,49,3,102055,46
f68d33abb3053ed9f061b915092a6aa1ccaa3612,org.apache.tika.parser,1,1,102055,0
76815ea5eb60c8f154adaef97a4047316049758e,org.apache.tika.parser,2,2,102055,0
6b174ecbb70d1236bdb9886f86bf94f51d3dd881,org.apache.tika.parser,3270,361,104964,2909
c020e48a263e2b2a29543ccc4a1946be8002c7f3,org.apache.tika.parser,29,13,104980,16
f78b7d0f16a86d86f18332b120e5f131c62948fb,org.apache.tika.parser,153,146,104987,7
ac1791af88e55fea8b1ff65987e32af93f528359,org.apache.tika.parser,66,66,104987,0
d51227f28bbbe7b94c51d76bf1e8c2c8b538ef88,org.apache.tika.parser,17,8,104996,9
ed57e6edb225948ca10e2fcb25f8e0fce45f8fc0,org.apache.tika.parser,73,35,105034,38
d87314734b7afe0687ffe756694e6f461a7e253e,org.apache.tika.parser,3,3,105034,0
477ce4cc58d91df2820c011b85dd5875ad603247,org.apache.tika.parser,23,17,105040,6
cba1cb214d1246f710b38c37b3463137b4dcb4c9,org.apache.tika.parser,4,6,105038,-2
d8d23745e3407e1efe95a1fac6708b80fcf494f3,org.apache.tika.parser,4,4,105038,0
614d951d82e4819ee960f370213f6b6c07a76cd4,org.apache.tika.parser,1,1,105038,0
de8720699c7713e4d0d41a691c08c9b1e45781e4,org.apache.tika.parser,7,13,105032,-6
5e19c01fe1c43173e3d9efe8da921035f890bc1f,org.apache.tika.parser,35,3,105064,32
b5b4eb6fde6c34c12d534e9412c0c73326b9886c,org.apache.tika.parser,100,55,105109,45
9d34cbb92a43bc52b4886954e0771ca6eea96bad,org.apache.tika.parser,100,55,105154,45
9f4bb56b7a8e2db8d5d60003531f6341563a8ee5,org.apache.tika.parser,0,36,105118,-36
ebc87aec539eef752072e95315daee65f7f42ebb,org.apache.tika.parser,11,3,105126,8
b2fc478e99b9814fde747d8f8eef03e054fb4d25,org.apache.tika.parser,64,0,105190,64
49f3530ea3540af21e0f6eda23fcd4c89728e5e4,org.apache.tika.parser,24,22,105192,2
f718cb9fbb2402745b0da69d1acd3b89a5a12246,org.apache.tika.parser,706,707,105191,-1
b290cd79d652741a0c8249f3860583b4169f6455,org.apache.tika.parser,67,0,105258,67
9ea855b189645e5a79b677b3e18d1676f7c009c5,org.apache.tika.parser,0,161,105097,-161
c35e257eb446caf6b9bb98364f93d9ce23d92975,org.apache.tika.parser,2,2,105097,0
4f06e2c212fe0df7c22445472627d2a4a028a1c4,org.apache.tika.parser,2,2,105097,0
cead1d087f3a8578c379710827b37998dadf9260,org.apache.tika.parser,158,6,105249,152
8979094a575b6432372855ddb149e9056ce99a8d,org.apache.tika.parser,10,2,105257,8
6be752c7e867ece0db96f36e8166cf97f8e5032a,org.apache.tika.parser,9,9,105257,0
6e9f796f15bf6640f8d43940d4bae13b609869df,org.apache.tika.parser,8,8,105257,0
d53fa483cb06a1afa5e10cdcce2bb42f980216a2,org.apache.tika.parser,15,6,105266,9
dab7788ab4e24cfd39fddef6939f2dc3304a5ea3,org.apache.tika.parser,66,39,105293,27
92fb7689c01ea4eb860d91dc72e36e263d2ab7e0,org.apache.tika.parser,54,14,105333,40
9a4f57672a27db0a161a4ff3e24551b2c8c529ea,org.apache.tika.parser,7,1,105339,6
8ffd67c92ba44caf877a0d3b28772569d15a1c75,org.apache.tika.parser,1,1,105339,0
f534fcec349341e89715381a8938c53d63230129,org.apache.tika.parser,5,7,105337,-2
574fcec5c469c94806c861b27ec38a0e87a28be3,org.apache.tika.parser,10,9,105338,1
77900ab626a2a05700cadf46f090966295c29149,org.apache.tika.parser,81,1146,104273,-1065
6d710da272285e04d6632b501e0752d020063182,org.apache.tika.parser,64,55,104282,9
a8aa2fc017262d961918085cf221c226b2979201,org.apache.tika.parser,50,8,104324,42
5410928d740baf6cdcf6ce225f105482f3a2fc11,org.apache.tika.parser,879,270,104933,609
7acf48d4c0b1ffcde5659a26e279f63ffb5ec0fc,org.apache.tika.parser,38,1,104970,37
d700aa4280760a34a33f01837b115cb6e32b120f,org.apache.tika.parser,300,0,105270,300
132d3e7ff0387234c65cfc2983dd2b6ba59ff38b,org.apache.tika.parser,167,7,105430,160
8410067c3d518e43d3f24d53832f5a3601157bba,org.apache.tika.parser,25,36,105419,-11
c53af436f0e7469a711fb92c931cb783f238db8e,org.apache.tika.parser,10,10,105419,0
1760249f26536047e54e3932f47910217a6c81f5,org.apache.tika.parser,24,23,105420,1
134cb3812aba88152f665c1d14ff65092f21d051,org.apache.tika.parser,2619,2674,105365,-55
2bdf7832ae4812eb03b402632b11ca1836c7ce4b,org.apache.tika.parser,25,13,105377,12
547831105073e44f8c8551bf48fe9e834861dc20,org.apache.tika.parser,6,4,105379,2
7b472396f34e76d806e184bef667b1c63c83c5a9,org.apache.tika.parser,7,5,105381,2
ebb4bc6d7bf82fe618b7a4b5f4e9b4278b96c0d2,org.apache.tika.parser,1108,301,106188,807
2369149b6e1ea32b7f6dd5fb6a55740686b0b602,org.apache.tika.parser,20,10,106198,10
6a60a798c69674fcb55c1f05eba0f134590f687c,org.apache.tika.parser,1,6,106193,-5
8ef1eb96e8ab5bad86c2e5d241658ac251a4f7f6,org.apache.tika.parser,0,6,106187,-6
bada130efe32560a5b3c26472029f3bd536040b8,org.apache.tika.parser,4,3,106188,1
443bc7d3332bb495872cea72c622b043cb2192f9,org.apache.tika.parser,4,3,106189,1
4161f2281bbc5b476b80e00c4fad7d54d1d12827,org.apache.tika.parser,243,69,106363,174
b409ff65abdb4d364db66be39be35513abf89b54,org.apache.tika.parser,2,2,106363,0
91d0af282a5349bc5c7dd122f85401796c7b0e6e,org.apache.tika.parser,21,0,106384,21
04cc72cd77c4f0d618f6dea7981779fae9807518,org.apache.tika.parser,6,6,106384,0
b618984cc78df5696886404c6579d2bad71e1bb8,org.apache.tika.parser,2846,2726,106504,120
8eef0562f82088db3bb66d17d8eb28188468112e,org.apache.tika.parser,257,67,106694,190
92b7b68f7c5197d094ed905d6ddac0cb6e9e2a42,org.apache.tika.parser,300,0,106994,300
4e24a14bae8a9b4ecad7d7f398c988477f2229f2,org.apache.tika.parser,6,1,106999,5
048dd8ee3c1e3c403c30bc509f4012da7abf348f,org.apache.tika.parser,1,0,107000,1
a549ec683455fa599efb828b335e542a3c57305e,org.apache.tika.parser,3,0,107003,3
2d48094bf1aef166fb0098c42f31da07c274d700,org.apache.tika.parser,16,13,107006,3
5a653d00da6bbeb7713d230c89c8bd5a33271098,org.apache.tika.parser,1,1,107006,0
f8cfa4b980e9eda2883070588542dec9abfc4532,org.apache.tika.parser,4,4,107006,0
ce4fdda61d093ea8796833a1d21a6d9d22603ae6,org.apache.tika.parser,2,2,107006,0
9ad510cc67871e266aece1684b21a94b524517c3,org.apache.tika.parser,1,0,107007,1
05f8f89fe6b531caacb8b39d1f344e96db834a39,org.apache.tika.parser,87,60,107034,27
0f6449fdf025ab81c88245026dc058208e6866cb,org.apache.tika.parser,316,3,107347,313
632f52db4713977aa93504517e57b8afe86e6e91,org.apache.tika.parser,16,2,107361,14
44082d3dd456a88c9d79b5a600db88a1a865416c,org.apache.tika.parser,18,12,107367,6
36d742eb99be7ee9167333d369f4eca5a7fd9ce4,org.apache.tika.parser,1296,66,108597,1230
2e7a4f5a976ad07284b83b9bc0e61ce63349cac7,org.apache.tika.parser,417,63,108951,354
b36a5b7a308a583206aabf0273ac5362ae08ccc6,org.apache.tika.parser,2,1,108952,1
2eabced07caef66f7d278e3212f53aff6e581746,org.apache.tika.parser,18,10,108960,8
56ab7b2305aa77c97cdcade9f843e905ebcfc446,org.apache.tika.parser,32,8,108984,24
268a815aef7a2c48d28fc3431fc77061524b1a00,org.apache.tika.parser,15,12,108987,3
d57a6216303f091778160d97f317a5f3e2d56d21,org.apache.tika.parser,10,7,108990,3
8af9c968d1a93f118f81cb207559abcf00c27c24,org.apache.tika.parser,10,7,108993,3
0d5cab940102d2713d3d9c363ce88b4de6661ff3,org.apache.tika.parser,8,5,108996,3
ef12f7d87ea52f1a3271f37472ba185e616ca125,org.apache.tika.parser,10,7,108999,3
c92730c3b19a64a9449210631155c3e9e3021129,org.apache.tika.parser,3,3,108999,0
63ae47a865ea3639927976daa9d97bb3fecd55e6,org.apache.tika.parser,20,14,109005,6
e2f5b1744c132668fade01a50b37bbcc72acf926,org.apache.tika.parser,25,6,109024,19
523f5d6b7a2fcd16c25a0103bde0745186c9191a,org.apache.tika.parser,50,3,109071,47
fe7533d8b59394fa75f647716ca6c1b4d5c2f8ee,org.apache.tika.parser,1,1,109071,0
0e1abd2c0751b9e4945f025c6d9695d7967e520e,org.apache.tika.parser,6,0,109077,6
0f57ea8d3df5b8fe757b50999a0cf6738baec64a,org.apache.tika.parser,6,0,109083,6
3621ee4abde21f66ebab200ba2788e160b8df65d,org.apache.tika.parser,1964,141,110906,1823
587e4ae5b0a87e01315156115c8b88d056036f96,org.apache.tika.parser,23,2,110927,21
aa12fc114ecc859117f898661bc2ac1c61cbb806,org.apache.tika.parser,6,2,110931,4
70de289b865043bab98a33e268e80e3ffce9ecee,org.apache.tika.parser,6,2,110935,4
a1533977852307c5095efaebfcc5a896d914a57c,org.apache.tika.parser,57,17,110975,40
83f1afae3db65af966b13e6cc6dae3872aef630f,org.apache.tika.parser,39,3,111011,36
e0ff3ebff559bcdad690498d40898d426c0b2b02,org.apache.tika.parser,9,16,111004,-7
3eff3ac86cb826faf76d98fb80147c28a4eb7562,org.apache.tika.parser,1,1,111004,0
560e91a176ca5ff1adfc3ff1c1f63e32ec4e928a,org.apache.tika.parser,16,0,111020,16
4de0c66ad4b28402597fd9cb03978ba00bdc2e9f,org.apache.tika.parser,9,0,111029,9
8000cfec02a0c872241a9bfe90c21675b9118054,org.apache.tika.parser,45,1,111073,44
5b57ae4d5218ec7af6388c6d5d51984566fc2511,org.apache.tika.parser,74,8,111139,66
582083e003efe45bd9e2e7a624a4177c9f1ddc50,org.apache.tika.parser,74,8,111205,66
b98712576088010198c3aa4cb07ceb55a753c7c4,org.apache.tika.parser,2,2,111205,0
7dd38d5500c539328e2b0a083e1998a28e680539,org.apache.tika.parser,221,26,111400,195
62d56653e676127bb4d8de39f383feadd513bddf,org.apache.tika.parser,2,2,111400,0
92fe9b88ffe16efea47ebbbf88dbf504d7cd7bb6,org.apache.tika.parser,2,2,111400,0
c0c2eafe46224e5c316f2dede395308930a5ec0d,org.apache.tika.parser,16,98,111318,-82
a78717c37fe50de4d82e5bbf7bc9d52af1c13bb6,org.apache.tika.parser,13,5,111326,8
4f784fc09c159849804b58f726ebba9b7f6ed28c,org.apache.tika.parser,181,179,111328,2
6b310534f736d275e7ff582f083ae289589fe99b,org.apache.tika.parser,5,5,111328,0
8a875cdbc9cb405a239f3c89192591c46fb078f0,org.apache.tika.parser,40,39,111329,1
712b69773863865f7aa207eecc291a9a010e76fe,org.apache.tika.parser,1,1,111329,0
9b94e17f2bceb0b79454689698bbb11c38a9ddd0,org.apache.tika.parser,26,37,111318,-11
07abb318a1d9fd1af1d2856627759337a95d3142,org.apache.tika.parser,66,38,111346,28
dead95609936fbe7fa8b382121b7efaf0adfa995,org.apache.tika.parser,20,42,111324,-22
92c65e0a43e7f09a0566bec34f352314dffe5def,org.apache.tika.parser,2,2,111324,0
2a81e975e48f2d1e051920725221fc5341e6db5f,org.apache.tika.parser,2,2,111324,0
ac259320057d8b7a8937dc5ee183b3a5c346a3bc,org.apache.tika.parser,31,0,111355,31
33da38ebb209250680aee3ab8565c89846f3a865,org.apache.tika.parser,69,3,111421,66
03e7d124b4b7c5bb786b24d115865085e6a2fc73,org.apache.tika.parser,12,12,111421,0
18aa69a16f09232413e06d04e921427ff4356cec,org.apache.tika.parser,16,2,111435,14
9653e77d935bb00b7a38be483991e8e185f751ff,org.apache.tika.parser,64,3,111496,61
9fb3461ec63bca0060660d210399270593c3584e,org.apache.tika.parser,432,296,111632,136
a043cefc0606a9bb05e19996b22ea56157cc775a,org.apache.tika.parser,18,96,111554,-78
f6beced5f4524515c88b09bbabfc192a383ce6de,org.apache.tika.parser,7,7,111554,0
17e4b66410a3bca6c749dda8c49bdb41f3d1b609,org.apache.tika.parser,90,0,111644,90
5c7547bac9208082920859a5040a8b9fa31da642,org.apache.tika.parser,77,11,111710,66
0d92bc862c3c344d65d3f6c260b0f5ea4c389fc0,org.apache.tika.parser,26,22,111714,4
1f28f464e91300cfd50f881ac37fd6d467d5dc7a,org.apache.tika.parser,77,2,111789,75
6fc2b7e7ffdd9ab4ffd4780ac24e9018292f066c,org.apache.tika.parser,77,2,111864,75
96a3502de309df863fcf37897466766e62d4e9a7,org.apache.tika.parser,21,96,111789,-75
b5f5403fb150f2a290fe1cfa10a6fe572b1dd50a,org.apache.tika.parser,394,176,112007,218
a01163de9784cff77733262dad46140e83eb6e11,org.apache.tika.parser,74,0,112081,74
877d62125dc6c670351eb84fc3422ed347db457a,org.apache.tika.parser,12,43,112050,-31
1047f64c7c814fac40b9b8669fb70577f96cc3e3,org.apache.tika.parser,21,22,112049,-1
ff481b25dd7f141f55907ce194b9bc2c77fc7069,org.apache.tika.parser,430,86,112393,344
c009dc71cc8428e0a752100af7e9d18d7e5e3096,org.apache.tika.parser,21,3,112411,18
690c74435bde80d8c69af220f5ba3c1d4d4f5407,org.apache.tika.parser,7,7,112411,0
d8caba1b7b22fe52bca747ea40d3cb8cb73d89ed,org.apache.tika.parser,168,87,112492,81
cc08d398141ada890be0305b6d0ba3909f61b0a9,org.apache.tika.parser,2,2,112492,0
9c2e1b9d839cffbc0820b789ffdd17a9a0b10759,org.apache.tika.parser,23,12,112503,11
1b48d73e41f6041c31ff396194ee37b5afceebae,org.apache.tika.parser,2,2,112503,0
06486c8548daf5f9ba588da4e88e3da82a429e70,org.apache.tika.parser,29,35,112497,-6
91ef9a972783b8638c2f31f904d5a0b9fdfa6074,org.apache.tika.parser,905,761,112641,144
3ee0aff615f49ae9c2678afa2c27a1737a329dcb,org.apache.tika.parser,0,271,112370,-271
fb93ab1d8ffd19cdc638f1599c672cc8d5a089c1,org.apache.tika.parser,43,9,112404,34
33bf39f374ecfeedb4776893e15e7a85000a1a56,org.apache.tika.parser,43,9,112438,34
2e274143c15a400f57d80335ad5bff367aae6c9b,org.apache.tika.parser,43,9,112472,34
72c4e33626118d563b02c151cb852141e367d585,org.apache.tika.parser,1,0,112473,1
7ca6597c5652ab8850bb8ce3d48d602188f5bdbf,org.apache.tika.parser,34,8,112499,26
537cfca9eae17a0270388810a557a8dc7faa0c30,org.apache.tika.parser,28,14,112513,14
b3434cd87fc454bfeccf149bc6644590f5678622,org.apache.tika.parser,62,22,112553,40
7a9411f9d06a667114f9ea67ad48f1099be1ec3b,org.apache.tika.parser,11,9,112555,2
aff782d5e88a3616055451de9526c0a40774bf87,org.apache.tika.parser,16,7,112564,9
f3acc8f23c2f0b5fb59e3587b605486b74d0c4f8,org.apache.tika.parser,1,1,112564,0
50295be0e1cd434228ac588a0299718c512436e8,org.apache.tika.parser,3,4,112563,-1
ac9f24e261e18afe0b43b577aafa59313552d386,org.apache.tika.parser,74,24,112613,50
2169cae44277a18430e4de462b4ae5b1dfb8956b,org.apache.tika.parser,62,45,112630,17
95baca2b58538ec1d75fc5b6c80fd06b7eebb7dc,org.apache.tika.parser,30,50,112610,-20
90d624588483f379180c812b7235bb2222be9c2e,org.apache.tika.parser,124,9,112725,115
533354d1a0e7e0b3b4ced7b7958f6e34041bf502,org.apache.tika.parser,7,1,112731,6
c2c73e9239e8957a390008bdf94df93e73def086,org.apache.tika.parser,33,0,112764,33
0b9aa9b5efde795f6b863c987abff5be07530a41,org.apache.tika.parser,6,2,112768,4
214b8923fdf0dae1e6866d5b75f4780306842c0d,org.apache.tika.parser,1,1,112768,0
ac2c024cee1e8475c056196aae0526120f99a85b,org.apache.tika.parser,40,3,112805,37
10a8eec119c7a77be76000b30aaffb96a552cc44,org.apache.tika.parser,245,361,112689,-116
e6e3b8817053e981f3843f1d3b7055b4ae30ed73,org.apache.tika.parser,245,361,112573,-116
0452f9888388fbbdf9d3a466820bc6c99893f88f,org.apache.tika.parser,6,6,112573,0
27a9c4069b6c1965d04a2a97d3c9a7ec131ff7e5,org.apache.tika.parser,65,10,112628,55
4645e43f48d95d058344946a169030b8efccc0ee,org.apache.tika.parser,11,0,112639,11
cef8494070cfbcb468c37da0f4732e2453d505ee,org.apache.tika.parser,3,0,112642,3
65defb20301d40397e94076a4b2011688cb94637,org.apache.tika.parser,23,0,112665,23
9ec8b43c269a79fe065c97eca66525a40eea3a41,org.apache.tika.parser,386,0,113051,386
0954278d204fa05ac16ada7dcc81a1ae3e4f42fc,org.apache.tika.parser,54,3,113102,51
3c1b66781dd541b8dfb0c0fe32e21b097af64aca,org.apache.tika.parser,2,2,113102,0
3701f2d340ee56af10aa1b6cc44375d71b50bb52,org.apache.tika.parser,14,1,113115,13
7e2b1e7534268b40c8b4ef3ee20ed708bf2e383c,org.apache.tika.parser,176,0,113291,176
462ee4744fd426cfdb12539435627b25e789c912,org.apache.tika.parser,95,2,113384,93
fcfd4e15fea1ba25a608b1d1b80147434985365e,org.apache.tika.parser,23,4,113403,19
bbf8447756887e00becc9beb201676de04a3fd2a,org.apache.tika.parser,3,0,113406,3
aa3134db90fc283d595a8ce35a0c4cd2c374e14c,org.apache.tika.parser,384,0,113790,384
62cf6f6cb3539ffbdb2886ff5485a997b0fe6773,org.apache.tika.parser,10,1,113799,9
d5a06ba6d17b0846cfc58b2e3c0a3df6abc31b0c,org.apache.tika.parser,3,21,113781,-18
427417c5d17f1e03724f3e6ded64779bf7366677,org.apache.tika.parser,7,0,113788,7
c3897db807970e7eb39c87840e4e040713eb759c,org.apache.tika.parser,7,1,113794,6
d229ab6f666cde8b007f568b13001a2c780ff477,org.apache.tika.parser,6,18,113782,-12
f4a926ca94c50a6158891c7746e725cd720a2faa,org.apache.tika.parser,3,3,113782,0
97b97b345b49b7dd510af560598e6d1ab7baf28c,org.apache.tika.parser,4,13,113773,-9
9be93c6bef2eabfb5ea93f60549762a2510b2dce,org.apache.tika.parser,6,3,113776,3
82f6f5f6068d72b2afcb6c47840b9124554afdbf,org.apache.tika.parser,13,15,113774,-2
ee60f5e8ac4002cb6a296adc24cbcb7183cb1f8e,org.apache.tika.parser,41,7,113808,34
348bfb9be46036833bbfda38c1912c9bf9eeb06e,org.apache.tika.parser,123,7,113924,116
819898fbde33384844ebc6b2caa4e6c6986463cf,org.apache.tika.parser,119,0,114043,119
62b02b0af4bb9260dc9417b5537144a0744fa55a,org.apache.tika.parser,75,24,114094,51
6a39214cc8303d393d0c5c288a973398d25a94c3,org.apache.tika.parser,80,3,114171,77
d181c3c05a70163597dd40a9e1b140303ec2739f,org.apache.tika.parser,44,10,114205,34
e82f7ce5743536b406fd6971016f6f048f42b3f5,org.apache.tika.parser,49,13,114241,36
c989d2f6aedcdf5375719ea1abe6ea136fc0e92c,org.apache.tika.parser,76,19,114298,57
12a98b63babc8515177d6f0e3df17ae8912142ee,org.apache.tika.parser,35,3,114330,32
f1f30673fea0d08f138488154c27f2c2205dd14f,org.apache.tika.parser,0,1,114329,-1
50f8591c6c87b756d6d8881c95f9794c51ffa240,org.apache.tika.parser,5,4,114330,1
f80fc232170f38216feee52a85087f17b4003311,org.apache.tika.parser,1,1,114330,0
54477aa3904944ca964e1f70188ac69b9f994042,org.apache.tika.parser,4,14,114320,-10
a761cf7005bc0d19e321c2e5811f5246782c4e1d,org.apache.tika.parser,3,3,114320,0
ee9e4f445dc8801fe69b5d7702c27aecbf9a6efd,org.apache.tika.parser,4,13,114311,-9
0af75e0a07b6e0ab1d58e06ab103698b3ca233b6,org.apache.tika.parser,8,1,114318,7
2cb195a7433fed2f7b37e46942316eedc924af52,org.apache.tika.parser,95,9,114404,86
8caffc06403b616cd3bcde9630db82fbd2f83ed6,org.apache.tika.parser,78,4,114478,74
3ecccf1b23a9e261c8e5949d20d045a2d0ca56ef,org.apache.tika.parser,78,4,114552,74
4cdb330526e7001997f939271b5185d2efb6451c,org.apache.tika.parser,37,0,114589,37
a830e20f544bb06bc5747cdf585f63243432677b,org.apache.tika.parser,7,9,114587,-2
4e7bdaf5b1cb6964075007a1f437b3d6fd08d139,org.apache.tika.parser,8,52,114543,-44
6fde37491d70ceefdc1181d7fa5d2d40be2720e4,org.apache.tika.parser,2,0,114545,2
d909b7763689a70e0422f43282e4ee67978cd471,org.apache.tika.parser,4,1,114548,3
d502a4b31348a0176a3999f07cf970bfa6a9dac1,org.apache.tika.parser,2,1,114549,1
c8b9b4409c72ded92d588660274977d5a6fdb539,org.apache.tika.parser,32,11,114570,21
dda50b6a82dcf45d38dc5a89cb60cc5ca82a01f6,org.apache.tika.parser,26,0,114596,26
f412d56218ffe21f65be4640aaf435c9896b3d16,org.apache.tika.parser,5,1,114600,4
26391d292df6ac001f812ab252659de30114bf8c,org.apache.tika.parser,4,7,114597,-3
742e60e20363aa66db992df4d1cae26b18060f45,org.apache.tika.parser,256,39,114814,217
c05c5245bdea38ddb9ef24e99ddcdc7bf7803d67,org.apache.tika.parser,4,0,114818,4
1a0d1d3056f0f45a3cb912939784f20767741e7e,org.apache.tika.parser,15,0,114833,15
ef049510c4243d6b7d7a1752a198426492c8fd7b,org.apache.tika.parser,169,41,114961,128
1b6ca3685c196cfd89f5f95c19cc919ce10c5aff,org.apache.tika.parser,10,2,114969,8
b38059f6a88e3f3414913909bb048769d5ef7ea4,org.apache.tika.parser,1,1,114969,0
af06e87f719f3c247d3da4da75e9c91dfbb25706,org.apache.tika.parser,15,8,114976,7
9c991c4ea5664e7b0ae619d13d8508f90cbdc5d8,org.apache.tika.parser,57,15,115018,42
dae7c0100df748c181729ac921e43e0917709a66,org.apache.tika.parser,7,0,115025,7
ceb7b42ba2e342e7becb81d0c661ccd6209a915e,org.apache.tika.parser,133,18,115140,115
d2c412940b976e607b698b598e25481495d0b8e4,org.apache.tika.parser,34,18,115156,16
754fb4c93b7229abc3512168228df2c269fb5274,org.apache.tika.parser,100,0,115256,100
53b61739b57a6d8e7db081708b3acd00535f8e99,org.apache.tika.parser,75,5,115326,70
fb4e39323b1d0576ea8066065febae94765a96c2,org.apache.tika.parser,4,9,115321,-5
15bcd7426e1403c56b6963b3d09c8c98542a106d,org.apache.tika.parser,85,6,115400,79
bf2846dde776c1cb55c2ae5f9cbe8d8f4f663dfa,org.apache.tika.parser,154,28,115526,126
1e45da928ab699cd3e483d5c1006412c69ff6c09,org.apache.tika.parser,1,4,115523,-3
4fa3cd1436c5d6d8eb924204e4700069dd9dd7a3,org.apache.tika.parser,249,0,115772,249
79f313d85ee558a2ba2e61477ec669ab0281dcb6,org.apache.tika.parser,64,46,115790,18
90720aed2836da7114f6495d61e12fd9af01d4fc,org.apache.tika.parser,21,2,115809,19
7d76112903777e909943fba2b50d9689801c6af9,org.apache.tika.parser,0,4,115805,-4
d4719f63ffb381dbbfc53e667379389cb26593c1,org.apache.tika.parser,71,0,115876,71
856cf35adf1e2ee5e03022b6e0347d0c6a5fd766,org.apache.tika.parser,8,0,115884,8
a0ffec146e84fdcf4c747b4375f92ae283944f4c,org.apache.tika.parser,2,1,115885,1
d0324f8e4fa70fce67d56dc70f611f5535fe229b,org.apache.tika.parser,32,19,115898,13
ca2f5bc63b7595730e53e95758dc9aaf6b567daa,org.apache.tika.parser,18,12,115904,6
1d7a113cdecf64a97a349d8ff74cad1ecd9127d3,org.apache.tika.parser,59,6,115957,53
7f89db35d066e6c4ae35490c5bad67d376e5365e,org.apache.tika.parser,61,16,116002,45
cfd62569a8f6bf79ba5d15bb3f4063d49347c7fd,org.apache.tika.parser,73,11,116064,62
6cff6029beb43163333e541169d788fe1884b338,org.apache.tika.parser,5,1,116068,4
d0fb69715e83a42db2ee5c2750eaa9d3b4f4d86c,org.apache.tika.parser,27,6,116089,21
72994c8ac8f0c749f26f4f19b7992b8224fc2a12,org.apache.tika.parser,56,45,116100,11
49833d88cb323928c3de7bd7a86ab38444530418,org.apache.tika.parser,11,3,116108,8
5f05b511d7d1184f6f25a2b644b615c4f21b8e68,org.apache.tika.parser,327,167,116268,160
b1b035e6bbcff0db24e133b682ac79916f92f599,org.apache.tika.parser,10,1,116277,9
b01b059331f198d3829b111002cf03cbcaf1bab3,org.apache.tika.parser,4,4,116277,0
348b87e7f41b79ff115e17d9c91d2dad63a57c15,org.apache.tika.parser,22,25,116274,-3
4b38d6228f4ba5ee912735dc692275499bbf45f6,org.apache.tika.parser,38,1,116311,37
64bb30844e0caafff1c9ebac7c8b0c5b512ea81e,org.apache.tika.parser,61,22,116350,39
8110645cc4b181fefd9663b1592213e79a298b0e,org.apache.tika.parser,7,2,116355,5
e24e6afb1c2a37be266839767115ad6adc5f8dcf,org.apache.tika.parser,76,138,116293,-62
7536ed91afd9a3fe744464e34f95f3108c6bd5a2,org.apache.tika.parser,48,55,116286,-7
bd554ebae29ba2685363c005c3c3282b3d0c1efe,org.apache.tika.parser,7,4,116289,3
8a6a9e1344f5b10ebfa1a189dc3c30d0da2b9d4b,org.apache.tika.parser,6,6,116289,0
1ffbb7a2144f1dd6957bdae644fe5769aa980094,org.apache.tika.parser,55,26,116318,29
dae1d5b3e00ab01b9e8de131afc731a8d1662a7b,org.apache.tika.parser,6,1,116323,5
bcf09e04d7b232a3d5ac56bd858045e63e41205d,org.apache.tika.parser,155,0,116478,155
e2156ce44ebf1eb49efc608e12dbec905112f39f,org.apache.tika.parser,126,2,116602,124
18f4e24451b1d835ab1897f49389788f78063a52,org.apache.tika.parser,22,0,116624,22
41bc34ca7e5c7d868755b0adaf992104cabd0c57,org.apache.tika.parser,16,0,116640,16
0edd73e7ce6f32cafb9554eb8bbca76c413efa1f,org.apache.tika.parser,22,0,116662,22
198d5ef995532f262c970f2ef76e64b852bed7f4,org.apache.tika.parser,1,1,116662,0
5ae7cc5d59006e15baa3347954e0545468c0dc94,org.apache.tika.parser,3,0,116665,3
cb1bbc052188bf5e45e5dc17570180df1fe27df9,org.apache.tika.parser,42,1,116706,41
7707dea4e0445b0e22e06c9d4cbd069bc72212e2,org.apache.tika.parser,17,7,116716,10
bc24ccb302d1454a226dbfd38337b8f8050d7e4a,org.apache.tika.parser,59,35,116740,24
a0325c2480357c99dff0fa99248886d3372269fa,org.apache.tika.parser,10,2,116748,8
7a69da1ba6b07fed00dbbf0ce7b822c3fb77a381,org.apache.tika.parser,50,2,116796,48
c844fc3928516f710a1e62ab99c4eb3f8ab27410,org.apache.tika.parser,12,14,116794,-2
b10c24dc8283401c9ef93b3a8535880ebfb30e6f,org.apache.tika.parser,21,22,116793,-1
d59353ea2ebeb4f0ea81a49bdd79810402f43416,org.apache.tika.parser,14,10,116797,4
b688afa01939a1f32775a7e7f0797a8ea466c612,org.apache.tika.parser,148,2,116943,146
5eec28ae0203820364dbcdef58335fd64aeb90ec,org.apache.tika.parser,1,1,116943,0
c9a81a400ee10e9342bbfe718d62f0b0d6c7944f,org.apache.tika.parser,28,2,116969,26
66417f619ba430f8c9e8ab0d903ebfecf936b071,org.apache.tika.parser,25,0,116994,25
790c1248207371e6cb2a3e7a1ec3a021503ec7a4,org.apache.tika.parser,1025,0,118019,1025
e7b481dd763ff4f586a94b981281923e4604010a,org.apache.tika.parser,1674,94,119599,1580
a6a7667b1e1d945bc2e219e61bd3c7b5897ab7ca,org.apache.tika.parser,814,725,119688,89
7d96565e25b3d607b91f9384e9df48b235423d0b,org.apache.tika.parser,3,4,119687,-1
82a1c61d628e604663b3b73326d44fbf57177af3,org.apache.tika.parser,9,2,119694,7
c27f53b8cb4918b957c782e3c856000f105c6d46,org.apache.tika.parser,1,1,119694,0
e7cda261f6aa2eb0102a8ffb53e454a4f3655bdd,org.apache.tika.parser,42,16,119720,26
60bba0696868fe1bb027e2ab3e5b7bbfbd0b75cc,org.apache.tika.parser,41,12,119749,29
6d2901374c4fc4a90c6d75357ae7a96b5d43a448,org.apache.tika.parser,12,8,119753,4
8851d511c4768a3200eafa06237b99ec263a201a,org.apache.tika.parser,46,13,119786,33
4b5b780623ba874c399098a1ed7720a12ee1d207,org.apache.tika.parser,2,1,119787,1
73232252c84a74c598014a7ba9d6ef63732a75d4,org.apache.tika.parser,846,725,119908,121
f8f5e23841d23cfcaa13bfba6dccf7f44f33fdd5,org.apache.tika.parser,5,74,119839,-69
6ef66723174ea15d4e168769dea6f76f0ad7bd91,org.apache.tika.parser,777,725,119891,52
f8a8447550afcff941700375774ad3cb92db4d8b,org.apache.tika.parser,2,2,119891,0
c892461520200143a09330473727da6c6e0a8c60,org.apache.tika.parser,10,24,119877,-14
519decf461a3b7004fbd4fa2d447763659f9d297,org.apache.tika.parser,186,46,120017,140
69555a98e56f4fef62abb91bee48bad27c58a6ce,org.apache.tika.parser,9,38,119988,-29
44c227904681c99097f3c2b0ef87379da0270a98,org.apache.tika.parser,0,5,119983,-5
5c7dafada7caee90635283d16b04d403eef7e047,org.apache.tika.parser,5,4,119984,1
e4f0fe5184db47724c6bf366a12ea0868972a83f,org.apache.tika.parser,20,11,119993,9
01c53eaa6d709972b03735574aa58dc0abcdc51c,org.apache.tika.parser,9,4,119998,5
5a4a0eecf61d7ced2a708d0184df5179c125dd4b,org.apache.tika.parser,61,96,119963,-35
927c224cde7a7358325c349a3c439766e8ad2988,org.apache.tika.parser,1,1,119963,0
e4d6d15f705232b0a422c01e217919e53b118fdf,org.apache.tika.parser,43,10,119996,33
744861f49a9295d22405b873158cda9f2414c2f5,org.apache.tika.parser,1,1,119996,0
86e997510b44f12dc9f90a68aaf583d5d3912892,org.apache.tika.parser,6,8,119994,-2
429b22b2ac9ff96cfca714895d65dce311522616,org.apache.tika.parser,2,2,119994,0
a0546b6cb98c949bb747b2e0e8d5675f651f6a16,org.apache.tika.parser,22,16,120000,6
68573d1a17315d134de6bec13666e02f3ec2aa45,org.apache.tika.parser,21,15,120006,6
f030fb38e00669ea3fa06f7850a9a869fc437008,org.apache.tika.parser,103,8,120101,95
6e3c26e45b1af10cd16eeb54f420826cf1330771,org.apache.tika.parser,23,17,120107,6
f7c3ece80e2db7e060deb0be3746d7dfa003303b,org.apache.tika.parser,82,61,120128,21
17cc77486d1c3f3e3379966b947687c57656a061,org.apache.tika.parser,28,1,120155,27
b13bb1528184f865f0e3170676b97c023a6a35bc,org.apache.tika.parser,213,70,120298,143
d6eb8b9fbf6eb6f1198c5b6f54931b065519bf79,org.apache.tika.parser,1,1,120298,0
02560a13408de42c960bab2807d8baec8ba2ab08,org.apache.tika.parser,21,15,120304,6
cff500c1aeb45d1cd4ab9b967505749e04a666c7,org.apache.tika.parser,59,1,120362,58
c723878ff15fc3b75f1a57fd1a91cf1d9f2577d3,org.apache.tika.parser,9,38,120333,-29
81430d51c45c2674efc6194e09e4cb3e3d1e3177,org.apache.tika.parser,39,8,120364,31
ca715e64451c7f73f1a6016bb87ae877bb1d4aa6,org.apache.tika.parser,0,19,120345,-19
4d4817bef686efc739a60cd724d8a252221dff1a,org.apache.tika.parser,42,8,120379,34
ef2cf1c9e1bcf596def63e21efd0a5170902b0e2,org.apache.tika.parser,0,1,120378,-1
10d380ae6c2805b2c4889ce7fe3034a5a8f9fa1a,org.apache.tika.parser,5,2,120381,3
7beae2f510d124adcb60178320317c5d161380d0,org.apache.tika.parser,29,17,120393,12
141ff9ca57cc5ec3a9ca3dcaac1832490ddc850b,org.apache.tika.parser,3,2,120394,1
b83dc002c771b2da50ef66afc22ffced2e54a487,org.apache.tika.parser,19,28,120385,-9
e301ee7a6a92dd901600c627e1f2ce10ac308a59,org.apache.tika.parser,22,14,120393,8
64302aa88bd8de81771712ccafa778a34cefd7c2,org.apache.tika.parser,10,10,120393,0
b9a822156f8fa29c2165958f5c7be83010160a70,org.apache.tika.parser,81,3,120471,78
536111459c780981b194f6ac159124be6bbffa3a,org.apache.tika.parser,44,7,120508,37
4ae1a10ec3f44f5278a1b741f0ea795c3f664cb3,org.apache.tika.parser,55,55,120508,0
6b5dd8bbe09eb099ec75846ec02391cbd32351c4,org.apache.tika.parser,27,6,120529,21
d0567c129d7d306695cb9306da7dff552c96031d,org.apache.tika.parser,155,14,120670,141
f84128fd46e0de75d20a9014ece553432ec926ac,org.apache.tika.parser,0,2,120668,-2
a178f61b1ba63f2e81d4c0fb6244a03de95f6399,org.apache.tika.parser,4,1,120671,3
3239f24863d5980395a6951e02e42fc9defcb37e,org.apache.tika.parser,180,309,120542,-129
a4881b5a9b0247b321455618e67837c2aa5312cd,org.apache.tika.parser,6,7,120541,-1
9d16008f49cbc3048071ab6f34daaef650efc124,org.apache.tika.parser,76,77,120540,-1
614190be65477afd956ce091dbe19eb5a8f51ade,org.apache.tika.parser,10,1,120549,9
8187f21aecf17d6796c36f2ef2f3d39ca6364ab0,org.apache.tika.parser,298,166,120681,132
93a2c2740edd803cba0273dec92e69c1f2a60dbe,org.apache.tika.parser,143,4,120820,139
d9229df3daa527cc09b9e231f923097f0577bb1f,org.apache.tika.parser,477,0,121297,477
baf0bb9c9c9fcc433c84b6047f78611af6675283,org.apache.tika.parser,1110,325,122082,785
84343bd2aa2ef1fbbfbb2d95bc824283ab6c9f42,org.apache.tika.parser,123,186,122019,-63
be7aa8441f5f0b5ad09aafe6c5e191b871f1bd4f,org.apache.tika.parser,20,3,122036,17
4131c6e30f2e0eb1feb85e0f7576531d4e830468,org.apache.tika.parser,540,27,122549,513
e36155767983a99d7f450256f5f751813c533e1b,org.apache.tika.parser,70,3,122616,67
f3099c81e57b5b7f297519a7586b9eb20d89b688,org.apache.tika.parser,45,3,122658,42
64877c5a6187ecd13e098e99edc97a1f6dc09112,org.apache.tika.parser,741,385,123014,356
cf5b8123769cb094163331a1395487c1f874c296,org.apache.tika.parser,741,385,123370,356
e83b999e0ab77971489356cca745746dd60aa55d,org.apache.tika.parser,8,2,123376,6
c797a83db923ceb01c9703f4a8a935c231eb9bd7,org.apache.tika.parser,6,6,123376,0
f9cccabcb2d2580739039fbef60f06da97668b13,org.apache.tika.parser,5,11,123370,-6
6745e8db32390ea94ca14f11ef02aa00f1ffc37e,org.apache.tika.parser,11,17,123364,-6
8afa4df9469b12f1be3dfaa1b2a136e8fa2c7988,org.apache.tika.parser,150,2,123512,148
1d9e44ed7b8ca4cb2a7033683f3ceb1828b2c56b,org.apache.tika.parser,2,1,123513,1
ae19bd1e996dec24236b1d555ef99e6c2a1cbd6b,org.apache.tika.parser,3,2,123514,1
f72841353c30ba0ece3bdd40570ccdb03c3f8994,org.apache.tika.parser,10,2,123522,8
2593a50e66a7a8543105158a27ad8e680634db27,org.apache.tika.parser,139,127,123534,12
4b330263d1759c35886e6243d5edc5426be54029,org.apache.tika.parser,56,5,123585,51
5c8195986744fb75f11388e4205d0d39f882c60d,org.apache.tika.parser,9,7,123587,2
c5280aeeea321f41260a414a4d02f2540e36bf2d,org.apache.tika.parser,2,5,123584,-3
7ec0dc07f360b431569e87f237b3cae3619d1568,org.apache.tika.parser,7,1,123590,6
c240c56afe3b168aa9e56634671592fecfa79960,org.apache.tika.parser,1,1,123590,0
f6644c577416c20ab8827ac857d75cf6874e093d,org.apache.tika.parser,34,2,123622,32
b1adfb9c67e6321264f4451af822f999081fc326,org.apache.tika.parser,37,5,123654,32
426be73b9e7500fa3d441231fa4e473de34743f6,org.apache.tika.parser,57,2,123709,55
06e734b3cfb192b96581338281c0373ef385d3cf,org.apache.tika.parser,2,1,123710,1
7175b9027fb4c8566822c57b428363bc35893d74,org.apache.tika.parser,102,0,123812,102
18f5ce047c7f5fac7eed47038a4d53b91a204711,org.apache.tika.parser,78,9,123881,69
03fa48a887262a72146e6227da4b5eff8c6f6024,org.apache.tika.parser,19,5,123895,14
477a8cad63c455be195e4a75468cc3e162e67688,org.apache.tika.parser,7,10,123892,-3
620134b90b72632fee486ba3aa5b25ff6b271d22,org.apache.tika.parser,3,1,123894,2
d83b3fafc4ebc3e8337d4a77a3aa9632985831a8,org.apache.tika.parser,53,11,123936,42
c21ba30e2b8bf3b9482c833cba4b150a7e3758a7,org.apache.tika.parser,791,0,124727,791
bc16d2e83b70d09167f4cf0a493e509ee1705320,org.apache.tika.parser,680,707,124700,-27
1845c4cbbc66734314dd21056ccc805f6fa18be6,org.apache.tika.parser,8,4,124704,4
72fa7951edb1a0dc87daeb82f9b1db7a1e80a253,org.apache.tika.parser,22,5,124721,17
ed1e9e8141c65233bf2b9e4df3eae797605fdcf0,org.apache.tika.parser,0,1,124720,-1
22ff7564f2641ba195f192d7c59e9df4a3a10747,org.apache.tika.parser,4,1,124723,3
1158d893dc952c573f7a12c7e4855cdce479fc2a,org.apache.tika.parser,24,0,124747,24
8266670708a8d133ada97b55b52c081c1ca524e5,org.apache.tika.parser,13,8,124752,5
2d73e91476325c235dc9a9be116e8d02c7658850,org.apache.tika.parser,1,1,124752,0
86325105ab206dca88d076dc865fcb17404c4531,org.apache.tika.parser,393,333,124812,60
cc43b276b60b1aabe01a2126363348db5a4d1888,org.apache.tika.parser,4,1,124815,3
dad1c722ceb7b8583f878d5e5bba88325f5f3530,org.apache.tika.parser,1,1,124815,0
903e62b3f223d8e5472a086c58156246117e6128,org.apache.tika.parser,43,11,124847,32
7866ce3cc182a02872f504640db22af4fcb3691a,org.apache.tika.parser,38,28,124857,10
6b237ac3cdb0b43b86884248f14424e217e19ea2,org.apache.tika.parser,74,3,124928,71
95cf1a364de643828334935e9552dd6c6f84c416,org.apache.tika.parser,14,13,124929,1
849fc385e626d904c50c3338d4668f6ab44bd72a,org.apache.tika.parser,3,26,124906,-23
76400ebbcf866c29e59b1767d538210809a623a2,org.apache.tika.parser,1,1,124906,0
375cacaac06ca079535499085db84493f0f9ea35,org.apache.tika.parser,3,4,124905,-1
d52f980a720409c90f850a3c5972f858e902fdb4,org.apache.tika.parser,2,0,124907,2
5cb880d6cbee6fd49580d11d8b472c05b04ff5f1,org.apache.tika.parser,53,7,124953,46
80b533b86cf8e4c8e090e95479ef60f2a641194f,org.apache.tika.parser,241,0,125194,241
e808d3fa0045894bc191c5eaec61c761aa21364e,org.apache.tika.parser,241,0,125435,241
e73fbfaa6aa46abe85dc9f561d802d68f6ed4d5d,org.apache.tika.parser,241,0,125676,241
f4bd11b84bd82fd072e5c4e246ba391a2ffbb5ff,org.apache.tika.parser,194,0,125870,194
4fc63fa02282aa02d5dd2f357d608a4f736f6f6b,org.apache.tika.parser,194,0,126064,194
bac63e33af4a7a934654839eac64f4291692f129,org.apache.tika.parser,15,2,126077,13
313ef8b53ad3bba3f0910bcfb25db683ba6ba209,org.apache.tika.parser,277,641,125713,-364
80a93bbffa12e4d58a1b6a026d06e680f3132509,org.apache.tika.parser,23,0,125736,23
cb3c4ba5c00eb633d42ca446a7d5bb8146701605,org.apache.tika.parser,5,0,125741,5
90b63b5f13509a8653c0efc9a69fab4b8cd7295f,org.apache.tika.parser,58,0,125799,58
ed232908f3a167809c677be5d74c9b1f694d391a,org.apache.tika.parser,4,5,125798,-1
6624902ac6dfe1dc230830aad0c9ff27a5bd8d82,org.apache.tika.parser,2,2,125798,0
e592f1e31d9bd6643cc25585d6321a31f2bf6b7a,org.apache.tika.parser,1,1,125798,0
abf8a5cfb05a7c86450fade620d6bded87b90ebc,org.apache.tika.parser,5,4,125799,1
84741757b512cb76a74ddd6c08756dc609243d3e,org.apache.tika.parser,2,1,125800,1
f5edbbd60ef22cce3fc2c8c23e617489d42be29f,org.apache.tika.parser,18,2,125816,16
31fe67d7ee016579ad3827c44fe7d2bf61f3efbe,org.apache.tika.parser,28,9,125835,19
8c0d7feb55988c2d6b34a96d8b2ab73884989bd4,org.apache.tika.parser,12,5,125842,7
970651a1b59189354a26c4c970741147ec266fe0,org.apache.tika.parser,12,7,125847,5
c93bf058633059d0eedc899bd8a4d90603ac10e1,org.apache.tika.parser,8,1,125854,7
a8b50c30e0963c5a07297adeb17b0ed988064adc,org.apache.tika.parser,10,11,125853,-1
9d2764319a42ac2169a9d0f0bc88f99fa226aea9,org.apache.tika.parser,8,1,125860,7
c85f5cc4729f1d6bd81c24bab375e89fd1037237,org.apache.tika.parser,0,6,125854,-6
e9ab0942ac7196429c4a297df9212792729e33f0,org.apache.tika.parser,31,6,125879,25
bdc797a03f2d5ce37386a5c655eb24bc39229cf2,org.apache.tika.parser,31,6,125904,25
64f0f9c59cf50e69a39a4133091021b6c3872b57,org.apache.tika.parser,15,1,125918,14
f5fa65fcc54f08e6ba57cb4b396753fbaa918c4a,org.apache.tika.parser,28,5,125941,23
eef11b45cf02a8f9cd290d9fdea6c31ab2817f43,org.apache.tika.parser,473,172,126242,301
9c855c94f57d0a18352aec319f698b479f394c25,org.apache.tika.parser,5,6,126241,-1
45e60a2a8285f49bd9d9f3bdde172b23d0f067a0,org.apache.tika.parser,729,5,126965,724
6d0ad3fe1880f9d3052cbb9eadae24f129f7c696,org.apache.tika.parser,0,1,126964,-1
fe2f4dd964279953a5fdfb8125a1d62290c1b271,org.apache.tika.parser,71,53,126982,18
c61d0d397aca1ce7c70403b7178d7e64b1f4cc7b,org.apache.tika.parser,295,0,127277,295
ab8a9ed830ec710a32e4ffdf4989aea3aaea92ef,org.apache.tika.parser,67,11,127333,56
c89fc0c95937b71e9c1a1b5905f34e0dc1cb650f,org.apache.tika.parser,284,8,127609,276
73eacc2d9bf77d962245b0832ba5d4fe0045ee56,org.apache.tika.parser,280,2,127887,278
5b27a993aca864e53093ab1bad9fa38dad6448cb,org.apache.tika.parser,38,14,127911,24
0974e5ef5df0a75af8652595937d5d923787bd98,org.apache.tika.parser,17,13,127915,4
9cb838227a020744e27c0b5adbbd1652c8f2dda1,org.apache.tika.parser,9,1,127923,8
6ea82881dac8191f3bce417adb4a2fabd18ef84f,org.apache.tika.parser,56,21,127958,35
7b83f7538c788af4cd1c9e997e64dc550e733dee,org.apache.tika.parser,7,1,127964,6
e6d3dec18ee639daaad13d422441f06f55376f83,org.apache.tika.parser,0,1,127963,-1
f3febf13f02e49c511fd2ba11431f0ab3b6da10f,org.apache.tika.parser,59,28,127994,31
a2f35a32fd989e940b70485a8f979ad92a375483,org.apache.tika.parser,18,14,127998,4
9fa992d01493272b87b85158192572b23189c6d8,org.apache.tika.parser,12,10,128000,2
b329820804bb74cc290337041eee595395e77435,org.apache.tika.parser,24,16,128008,8
6ca83a4d3d068752d841658ac4c20caa77538d60,org.apache.tika.parser,3,0,128011,3
a90a95b96a019b45fd8d10e82c48fcf633fbb064,org.apache.tika.parser,6,0,128017,6
adf791ab2e928b31264c5666d7e5ba03b92860af,org.apache.tika.parser,210,315,127912,-105
d811de93fe1d1f356e58708a06b300017a7a2f51,org.apache.tika.parser,31,3,127940,28
ae60b205b45e89c7cde7792937faa37a03dbf9db,org.apache.tika.parser,29,14,127955,15
bb4458e417116cfc1b7cba70783c5a97c9ec3681,org.apache.tika.parser,79,4,128030,75
f4626a60be540fc0038858d6226c54912c41d5f9,org.apache.tika.parser,5,0,128035,5
48884e597aac219e5e97635f5297bb0d005e607f,org.apache.tika.parser,160,0,128195,160
424161d7cbe3d3615324f689db964b9b0c1f89a8,org.apache.tika.parser,99,25,128269,74
6ce75ef385553490300e3e9e8dd26dbdc300e18e,org.apache.tika.parser,2,1,128270,1
f52838fd0c88c4c843c2cd778fd32ea7184bc902,org.apache.tika.parser,114,0,128384,114
65ae67eb163918d449242b47c2bfbb3cd99d7ecd,org.apache.tika.parser,4,0,128388,4
81bbd8b307b776e61bbe997e8bf6bd1bd1cedb13,org.apache.tika.parser,10,5,128393,5
500f2f80b50a76ad4abc8864cdd0638c44d6da99,org.apache.tika.parser,1,1,128393,0
d9dbe0c8ca20b5954f04b0633ec1e34bd5ffc4d9,org.apache.tika.parser,140,0,128533,140
ea9f083abbdc45793ff204b48d942ad85b47af43,org.apache.tika.parser,2,2,128533,0
40a06ae1277f0b211326a1121c2be615f8aefb3e,org.apache.tika.parser,95,5,128623,90
62fe4ada48f961ec49a41f6b67f28a64681c9b93,org.apache.tika.parser,37,13,128647,24
053986f1ab9fab1bc68704cd9a81dd8d2acf283f,org.apache.tika.parser,12,0,128659,12
18d0c735588cd1fe83fb6c09cd333ecffd084b48,org.apache.tika.parser,4,12,128651,-8
5f747ac3c7d19224cd9d9086346251096c1109fc,org.apache.tika.parser,2,2,128651,0
44a30b3b7985415cf315f6354b37961bf90e7b49,org.apache.tika.parser,2,2,128651,0
d6257f4586a5c7061f09e534074ecddff486aafa,org.apache.tika.parser,3,3,128651,0
3bdcd9714b8259c7c8c2ae1d5837148016d5bdaf,org.apache.tika.parser,74,0,128725,74
eb6e07eee192ba961272e4a58eb3bb40bb2371c8,org.apache.tika.parser,5,3,128727,2
4971e2e435ff433f8d489959001b8ff8e05fef7f,org.apache.tika.parser,5,1,128731,4
bf224dc2f09c029df3f93ae0b136eb294e2c233f,org.apache.tika.parser,82,2,128811,80
4e057270f075a36e535f55f1542972d6fa566dbf,org.apache.tika.parser,1,1,128811,0
114f93e61f91e83bc029f35ccd2421bca585f91d,org.apache.tika.parser,994,530,129275,464
611417f64e3d1848f0903951f624cc65a0aa5e27,org.apache.tika.parser,239,59,129455,180
518bd27aadf3d311db031bbd305795e0dac10b8f,org.apache.tika.parser,178,71,129562,107
7f0394247c8f5a731b258adbd6683449bc5c757b,org.apache.tika.parser,2,10,129554,-8
f9104d17ad0b92b243501fdf0863b4ccdaa5e791,org.apache.tika.parser,27740,38921,118373,-11181
b9822c8935068375b689c618c20c941574940df9,org.apache.tika.parser,1,0,118374,1
236125ab1ec492f393fcbf26af0df30c8ae7619a,org.apache.tika.parser,3,3,118374,0
d4a39b4873d939553e0742487b8c84f072497c1f,org.apache.tika.parser,176,0,118550,176
e91be37c1c7ce706af4c2dbe23eb24308f134547,org.apache.tika.parser,1,1,118550,0
a504d7e7e8cfccbbda0d31c9362358ea4900c1ec,org.apache.tika.parser,1,3,118548,-2
c6785c690c7eb8d95bd3f035afb408cd3c86e277,org.apache.tika.parser,5,2,118551,3
9061507658630b98d8048841c3f97f54b46ad456,org.apache.tika.parser,3,3,118551,0
b5c3485e9f1c390565ccc0abc5e4609fdab9bd0a,org.apache.tika.parser,295,257,118589,38
a8d2aac3e883c216a309f56f2b886f31ea669260,org.apache.tika.parser,29,15,118603,14
c10229588800e6d56907a19abc3d116b4b423169,org.apache.tika.parser,452,0,119055,452
aba3e433510f02300ff627df74d09fdfb372cf38,org.apache.tika.parser,110,14,119151,96
6591b32fd6e60e29b505e78e8fb8529be337ef75,org.apache.tika.parser,34,23,119162,11
4c7affbffc2e0723826edacb7ebdc4498cdd05b9,org.apache.tika.parser,4,3,119163,1
d2449f9f9302a1479b067f408ee067aad221e45e,org.apache.tika.parser,0,1,119162,-1
f29362d91b46864a7f924c60f7cf691ac18f11b2,org.apache.tika.parser,7,7,119162,0
2504756b68223b429d481877f4977fc995f24724,org.apache.tika.parser,58,27,119193,31
53fef890942bdf69d455abbbecc17cd22d6621d6,org.apache.tika.parser,4,28,119169,-24
44c0c83971ab5503db4e7258e258a0d3a360594a,org.apache.tika.parser,4,28,119145,-24
7595d820633d2588234b6650ab36265a4dcdfec0,org.apache.tika.parser,7,7,119145,0
2b456679200bd8b2e86864ae6db847923d2bc134,org.apache.tika.parser,38,7,119176,31
e8e2c6bdf0ad50d8726df527194e4f104d4c79c0,org.apache.tika.parser,10,4,119182,6
b417bf73345c0ae131270c36b64f6555f94e8168,org.apache.tika.parser,10,4,119188,6
1957a60575075fe60e367a506bdbf0136d653547,org.apache.tika.parser,35,16,119207,19
faad4c316634880df054dc6178e18f172a132d4e,org.apache.tika.parser,120,201,119126,-81
37f0559c28dd485557f5d66e9c0fe6cb6123b225,org.apache.tika.parser,120,201,119045,-81
8dfee9ecff0ad4f01555abdae82d5e5e8e5c8690,org.apache.tika.parser,10,17,119038,-7
49bd7d574143fde300151f70319d9cc25559e66d,org.apache.tika.parser,10,17,119031,-7
7ed64a5bd8e564bbe8fce0948a71c1db249fa2fb,org.apache.tika.parser,8,8,119031,0
372ccd23e6399de9b5d9d93906645e1e4349ec99,org.apache.tika.parser,4,13,119022,-9
ed73391ce867d82151578835611a5b063eac2abc,org.apache.tika.parser,1,1,119022,0
6401ca084ac9409bf6b6c94b2fa4ff293e427133,org.apache.tika.parser,71,98,118995,-27
6b3fb1fa644a93e25f640d08593c849fe24a7784,org.apache.tika.parser,2,10,118987,-8
9ec102102119e6d398c53652e1a28c2c61600f5d,org.apache.tika.parser,97,102,118982,-5
82cf5c0bf0874ccd4c4d66d9eb54912438a09290,org.apache.tika.parser,85,0,119067,85
f23d3777120dd86e1a5e8c1cd43f6f178f1ec956,org.apache.tika.parser,1,1,119067,0
3571725a948a4676f1904799209271eeaf18b102,org.apache.tika.parser,5,10,119062,-5
2892ad5454f7cd006d879a2883a5f55926d884c5,org.apache.tika.parser,54,0,119116,54
8dbb5736fa92b323e270e2075b42dce458a3abd6,org.apache.tika.parser,0,20536,98580,-20536
a43784b19f6b0955478dded71521b0491d21c90b,org.apache.tika.parser,20377,0,118957,20377
12198666bf0cf6811613c9ae27c4a384e42875b1,org.apache.tika.parser,159,0,119116,159
074d135e58b3fbaa832056d62c96393bb94fc42e,org.apache.tika.parser,54,0,119170,54
ee777a3cf9645329e5c247bc7acdabd2155fc297,org.apache.tika.parser,2,2,119170,0
e3e6c87ba963e5bf9eba211c2795d6f743830def,org.apache.tika.parser,54,0,119224,54
b8404b68139955eb49e85c0270700038816b7d0b,org.apache.tika.parser,2,2,119224,0
8b82b4c942c82f9cc2eb393e669227606b5f15fc,org.apache.tika.parser,1,1,119224,0
3173e12b40ead8065db6053118af23699c7748d9,org.apache.tika.parser,0,54,119170,-54
e8fa990e201f9ffdef2da3b0e2237a0b93ed9353,org.apache.tika.parser,56,6,119220,50
081070065ec2a989ecfccb9d1186610bbce52f5e,org.apache.tika.parser,13,11,119222,2
dd85c73094dc87f6f6e208278325be810761f490,org.apache.tika.parser,6,11,119217,-5
326b7d7abda238ccc181fc2acaf2271e08fe9c1b,org.apache.tika.parser,11,6,119222,5
7f65d61b4fe1f4c1d4929bbe1c456c68afd44b6c,org.apache.tika.parser,6,11,119217,-5
e759bbbc8afcc8d490562eb08c14a10c509adc20,org.apache.tika.parser.microsoft,3,3,0,0
1081cb5beded2bd1228de19f74c6349ca674afed,org.apache.tika.parser.microsoft,328,214,114,114
4c8f0b8fff933890990c336e40ff5a419d08321c,org.apache.tika.parser.microsoft,4,4,114,0
91913d37243cdab7a8a0c0de132b538ed6b0419e,org.apache.tika.parser.microsoft,31,41,104,-10
ae5915aa8fcc10f0dedb9a3454e42ff1f101ecc8,org.apache.tika.parser.microsoft,486,0,590,486
d795c5fe92f6a2de1811515ec7851485a2840c74,org.apache.tika.parser.microsoft,25,173,442,-148
7fdba7e3aca7f53baceb77b57d8692065b9da816,org.apache.tika.parser.microsoft,458,569,331,-111
4ed2d4be6a683c65f377711fbf83c236889caff1,org.apache.tika.parser.microsoft,528,665,194,-137
71aee51283638d20ec62c0f64aa6a615e904cdb9,org.apache.tika.parser.microsoft,1,1,194,0
9398c06ff62b72c6d9b66996a824ca45daf32f74,org.apache.tika.parser.microsoft,6,533,-333,-527
1cd1b27955a969faefc7c6f3c2c70987bd3f693a,org.apache.tika.parser.microsoft,6,590,-917,-584
71588810d7cf06b5197869646b86102f57f2f6ae,org.apache.tika.parser.microsoft,109,97,-905,12
75fb47bf42a15ed7708e9174ce1113a9914fb2eb,org.apache.tika.parser.microsoft,112,236,-1029,-124
3a743efd63e737bfa0ef621923f6c9a2b7c1e50b,org.apache.tika.parser.microsoft,25,0,-1004,25
c26e7b3e91781a62cad161c35c6b88fa3a1a589d,org.apache.tika.parser.microsoft,10,0,-994,10
49028e378c94b1c3a8b7aa1fe69cd5bd8840970e,org.apache.tika.parser.microsoft,351,47,-690,304
f81d990e14a2817176abb599d63ca200a3477101,org.apache.tika.parser.microsoft,51,260,-899,-209
cdd4cf3a7f040a0b1c1de56f2439fae225e60fc9,org.apache.tika.parser.microsoft,161,62,-800,99
a8c7b385aaea4ff55c82bb189df3cc7bf1d499bb,org.apache.tika.parser.microsoft,11,7,-796,4
474c19fc8fbf981f60bd3a7a8ed078b5a14a45f6,org.apache.tika.parser.microsoft,49,10,-757,39
9da6dd5e394f42276ec60512d73606caf78777ba,org.apache.tika.parser.microsoft,37,15,-735,22
f6d4c07ca81fad73b9df476a05d0ec0fd6a5f768,org.apache.tika.parser.microsoft,15,27,-747,-12
9028d6f302ebba13eb32a59bea1332e0610fbc9e,org.apache.tika.parser.microsoft,67,87,-767,-20
6f20d1a945e41734e0cc90710855b2ec23d5750b,org.apache.tika.parser.microsoft,17,9,-759,8
f198ac1ddb043e42dcd312284ca055f5088d6f22,org.apache.tika.parser.microsoft,42,23,-740,19
8740cb54cd906c066e6c016e44356a03925304e2,org.apache.tika.parser.microsoft,4,2,-738,2
64e1e5180b49b78fa4559b3d88503e6d9825483c,org.apache.tika.parser.microsoft,11,18,-745,-7
91d107748f031f88a4d8e25075509e2455491fbc,org.apache.tika.parser.microsoft,13,13,-745,0
73603f4b32ecd55aeccfb4e6549f4640042b5288,org.apache.tika.parser.microsoft,55,0,-690,55
79a504863f87fce9ae79a3e9a233432f2fef7f83,org.apache.tika.parser.microsoft,166,55,-579,111
df019d958207998fc9597e37ad591f904d67b0f5,org.apache.tika.parser.microsoft,5,4,-578,1
7d8686cb5e5ecf6d5a7268f8f3517b49440eddae,org.apache.tika.parser.microsoft,0,29,-607,-29
3079789724edf724c492c3497630c3cbd5533ef5,org.apache.tika.parser.microsoft,757,757,-607,0
aac081e097de07b99e9d4975bf7da5be55114492,org.apache.tika.parser.microsoft,1,1,-607,0
a9fb61439bf092318680fde1dad4e9d91aea96af,org.apache.tika.parser.microsoft,0,8,-615,-8
dd352d27c1b955103b2be76f2d5bca88f3b8e48b,org.apache.tika.parser.microsoft,5,3,-613,2
6397cdecef04b977d90c8638fdc1064870cd6a6b,org.apache.tika.parser.microsoft,0,1,-614,-1
f6f9d4fe18590bfd8b03e5e87b75af9a18ee059e,org.apache.tika.parser.microsoft,35,1,-580,34
1588c38e20098a1f728ebd160d240fd1c032c701,org.apache.tika.parser.microsoft,6,6,-580,0
035d8d3dad64179c6eda295233f064d0e0310f1b,org.apache.tika.parser.microsoft,13,8,-575,5
bb1ed46196848b57747b5ef22d60fca0155872e9,org.apache.tika.parser.microsoft,1,1,-575,0
96742ab2fe31bd8d6031d0730baec6df26929b86,org.apache.tika.parser.microsoft,0,10,-585,-10
2d893ab1f8d5600746a4a8ba1104cd1cf29fd1e5,org.apache.tika.parser.microsoft,14,0,-571,14
410d4934833119b7ae0e5f766e28a06ba4fbb2c8,org.apache.tika.parser.microsoft,18,6,-559,12
74947b6cf59fafedef133bebee40d442b4559972,org.apache.tika.parser.microsoft,20,0,-539,20
ace49289168ed9367a6ed48a59f37719a9a544b9,org.apache.tika.parser.microsoft,16,5,-528,11
5099b33a3552b1dbcb2b046057910f6d8edf3ab6,org.apache.tika.parser.microsoft,1,1,-528,0
3922b01361d5958a31c199e376e7a979a3a6d376,org.apache.tika.parser.microsoft,14,1,-515,13
0486ffb7be6bb98ba1a6d9737865789e09f9e175,org.apache.tika.parser.microsoft,15,0,-500,15
ad11aac0a56344521d33306b36f645f984173531,org.apache.tika.parser.microsoft,3,5,-502,-2
bf856a4ed21bb0699d11b7971a43a8e54f982b50,org.apache.tika.parser.microsoft,14,10,-498,4
895590e57650e805ecf8561742e06c4f504f664b,org.apache.tika.parser.microsoft,117,32,-413,85
093a62b2a223842d596f3a7381abcb65a32554c2,org.apache.tika.parser.microsoft,13,0,-400,13
4a8ca9ce9882174184a149222ee35fbb5a65231d,org.apache.tika.parser.microsoft,154,46,-292,108
33171a5635184bfcf54afccd72b0dee0529f9f0a,org.apache.tika.parser.microsoft,25,6,-273,19
c9d44dbdd1cf61f17ed07d0df36af95d9ca51d0a,org.apache.tika.parser.microsoft,141,101,-233,40
cca6e63be096b1f1225ff7dea5336ee2048cb41b,org.apache.tika.parser.microsoft,40,8,-201,32
d06aed21f4790446e336c56ed55f2c198e0ae388,org.apache.tika.parser.microsoft,30,0,-171,30
afc05233775ffde664369dd9e296be00f9e2e79a,org.apache.tika.parser.microsoft,16,9,-164,7
ed8497d10df01374ddc63ec6cc988c191a881b95,org.apache.tika.parser.microsoft,112,80,-132,32
85a8a767146619a071f89c72aa4ab25baec6ee98,org.apache.tika.parser.microsoft,172,71,-31,101
11970650568d41bd2318d3513c011240b7be3ecf,org.apache.tika.parser.microsoft,14,19,-36,-5
b8223f9c1353db748a7e1869bd9fe77e5e0ad5d7,org.apache.tika.parser.microsoft,3,1,-34,2
76afce1f5f8fa9e638304b838bdea8b5816b3abf,org.apache.tika.parser.microsoft,0,1,-35,-1
6cd30a3fcea1bbdc12c44029f2472130c4f2d17c,org.apache.tika.parser.microsoft,7,0,-28,7
3ca5da94c605fb8f6d0bbc5e6849e07e0adf1c8c,org.apache.tika.parser.microsoft,8,1,-21,7
f49c4bdbe322506c6ddbf301cf842ac14eac3d67,org.apache.tika.parser.microsoft,103,7,75,96
40de6ed08e7fd0abb09053b429b9c7248cb53b8b,org.apache.tika.parser.microsoft,2,0,77,2
f9e1dddacfeda4498dfe7c09feee33a403ef3e7c,org.apache.tika.parser.microsoft,7,1,83,6
4bf74e902340b89da31eb1427b9b0f19647de9e4,org.apache.tika.parser.microsoft,4,0,87,4
d2877b762d09ba8c517f63e639dbbc289a092b90,org.apache.tika.parser.microsoft,359,3,443,356
8dd9c86fcd28c90d279ca06d0d99e7b7e7f51e50,org.apache.tika.parser.microsoft,215,222,436,-7
c3859d25f9e362f3eb72cbf70242935cf794ab67,org.apache.tika.parser.microsoft,194,24,606,170
c6505eff00128e7bd1e539a1d729df97197567bc,org.apache.tika.parser.microsoft,109,24,691,85
ca80cad420b6562c57058384a166390d289da9a6,org.apache.tika.parser.microsoft,47,44,694,3
2d822bce6cda2e38b5ebb12af74073df41e8e7e9,org.apache.tika.parser.microsoft,83,54,723,29
274acac0c57b8d0b7fa904524ff9723e688a86a3,org.apache.tika.parser.microsoft,16,17,722,-1
cdd1aa5684e484841aaf0c49138e712f6bfcc8aa,org.apache.tika.parser.microsoft,45,26,741,19
3864c2ef1dd3d300b67f46cdc1e7df9974a08d08,org.apache.tika.parser.microsoft,0,4,737,-4
bb7ab51eddf12aba8623e6436f3aafa36f989090,org.apache.tika.parser.microsoft,42,3,776,39
d0cd679a119eb1ebcea1bce1f0d0ce9ea39e72bd,org.apache.tika.parser.microsoft,419,78,1117,341
1bd3087a3ac99cb42aa7d4715de7603e9b7c39b5,org.apache.tika.parser.microsoft,2,0,1119,2
c442efe169e285129c1e5e33bbaea7f4d07b450a,org.apache.tika.parser.microsoft,2,0,1121,2
f9495f189acc35c1f1fa4643ce2648cccee2b6fe,org.apache.tika.parser.microsoft,152,64,1209,88
3bc4231d0cecfb066e9f6d70326783f9068a5e17,org.apache.tika.parser.microsoft,21,0,1230,21
15851353b213a8edf6696f529cf3d8609eeec182,org.apache.tika.parser.microsoft,8,1,1237,7
67695ebac531e4c17ebcf2055684f8342df86992,org.apache.tika.parser.microsoft,43,15,1265,28
7413cfdf4df6dfd2664980c176ed6fa6b7459ccd,org.apache.tika.parser.microsoft,22,19,1268,3
bbd3acfc8182f7846ebea710ed64e90573236785,org.apache.tika.parser.microsoft,56,0,1324,56
9dbebc4ec825b6e7dab852c3d3427b003c8b81eb,org.apache.tika.parser.microsoft,8,7,1325,1
21c35f73d28d88d0ec8db91a7a458fe70da85f84,org.apache.tika.parser.microsoft,4,3,1326,1
3dd12110dad0e5a71555d4e4a0e5a6cd609b0fb7,org.apache.tika.parser.microsoft,18,2,1342,16
dba5043a3beb6fc0ef732c6a7553d0f7071ea802,org.apache.tika.parser.microsoft,2,2,1342,0
05f333cec46f9e48312de6bde67722bc4cf5b41c,org.apache.tika.parser.microsoft,32,18,1356,14
b6f45ba65a19f05aebded8444e0de3aab35dc175,org.apache.tika.parser.microsoft,12,8,1360,4
b65fad1d762bdc691258a4b5d473671e1162801f,org.apache.tika.parser.microsoft,1,1,1360,0
9ffe396ea8e935d63e65b515478d0709a00e1bd4,org.apache.tika.parser.microsoft,3,1,1362,2
b13d07e924ccf7e0e0109082358ed69ffb8d9a71,org.apache.tika.parser.microsoft,56,7,1411,49
b206755d21482a519180e5a70f760e494ee73252,org.apache.tika.parser.microsoft,3,2,1412,1
e09dc3012056e0d28eeed5433da89229eee935d7,org.apache.tika.parser.microsoft,12,7,1417,5
3b61cea5aba160f9289db7d913aec2c00c3b7a6e,org.apache.tika.parser.microsoft,4,11,1410,-7
0ea4a153465745881c2ef6e3ae39700a38e39e53,org.apache.tika.parser.microsoft,77,3,1484,74
2ffde960d27a407818f42d6f6fabf5b9e47f5afc,org.apache.tika.parser.microsoft,15,3,1496,12
336bf6748dc1ec027383bce06be418b520040055,org.apache.tika.parser.microsoft,192,0,1688,192
f6a4a013196e34cdea1d6b1374d3ad1cf59864f8,org.apache.tika.parser.microsoft,2,11,1679,-9
90b0f8e906a5890b6c41bfc4f7b234cdbe24bcab,org.apache.tika.parser.microsoft,37,22,1694,15
9c9d6f85aa15ab2e65d103b0b0d34769dbfe100c,org.apache.tika.parser.microsoft,2,1,1695,1
cac8d4c80d8dd2548660c6b94306560bd2858533,org.apache.tika.parser.microsoft,0,1,1694,-1
1fe4980675cd5e869c6dbf97465e154166a1393a,org.apache.tika.parser.microsoft,22,1,1715,21
e6e7650d75f86b7aef1197e58e865f0a1bc55c49,org.apache.tika.parser.microsoft,12,8,1719,4
469aa10c4736a905e343fe77e64fa9c7bec843b6,org.apache.tika.parser.microsoft,8,7,1720,1
8ef4561642c3b0b4173480b82708e192ac06d2a3,org.apache.tika.parser.microsoft,25,5,1740,20
1835ad392b2ed8ce0673483833fb28f3f8bdc855,org.apache.tika.parser.microsoft,40,0,1780,40
77c7847b54d396de91f281f4c58ff69d67ee9910,org.apache.tika.parser.microsoft,9,5,1784,4
2ff952a9137955ae7ce16d7e8908c374b034db35,org.apache.tika.parser.microsoft,28,32,1780,-4
49692dead827eac2b7a0f9c6b6e48f97eabd5dae,org.apache.tika.parser.microsoft,15,9,1786,6
fb732d60934a4132131c89f668b21568799edee5,org.apache.tika.parser.microsoft,1,1,1786,0
75e5f97c8b23cf168a424a6bf1133ce0bd4937a2,org.apache.tika.parser.microsoft,57,19,1824,38
9ffaf87bd8dc63bc532ea231415187377903f08c,org.apache.tika.parser.microsoft,1,2,1823,-1
332e4986fc077212784ada8d5f3048473ccd06b4,org.apache.tika.parser.microsoft,135,57,1901,78
c3318a107e894b6c38b5ab753ba999583c8a99b2,org.apache.tika.parser.microsoft,1,1,1901,0
33595666efff7b475e461af98446e682a5724ca5,org.apache.tika.parser.microsoft,44,46,1899,-2
6bd95ee7eec85356b90d407084c4e45eec97e8df,org.apache.tika.parser.microsoft,30,34,1895,-4
411d5d8a30873e82c4dddc1497b944ec862533e9,org.apache.tika.parser.microsoft,13,2,1906,11
e25a4543bcd1414d1288bb544b65afc8727a6f87,org.apache.tika.parser.microsoft,9,0,1915,9
07f6f6341cc11520eb1de18a4b9b712ac514f28d,org.apache.tika.parser.microsoft,139,7,2047,132
04d1fb7cc895e054941280e991ef129cde11ab8b,org.apache.tika.parser.microsoft,6,1,2052,5
505a83529bc4ba580fb3a65877c7e32e10a8a66c,org.apache.tika.parser.microsoft,15,11,2056,4
5c22595f655362f983e73aca4fb79149f37a17ec,org.apache.tika.parser.microsoft,2,0,2058,2
111fcd5384f2265c220d8578a2d6bfb552fffa48,org.apache.tika.parser.microsoft,3,2,2059,1
a5429c512b2844183f735c8bc6990de965af7f31,org.apache.tika.parser.microsoft,6,1,2064,5
acbefdf903b19385d7557cf6c41380afe81b5eed,org.apache.tika.parser.microsoft,6,1,2069,5
1de7bfe9080607ab8c0b052a84d7939539c854c7,org.apache.tika.parser.microsoft,16,0,2085,16
ec9d7d201f0fb580a32b599a6340a220063ca82c,org.apache.tika.parser.microsoft,5,2,2088,3
0d2676c5e558ebb08c1178e6d4da5c26cc38ebc7,org.apache.tika.parser.microsoft,165,36,2217,129
7aeed0b52f5fbd5a1955270046220350d9a72885,org.apache.tika.parser.microsoft,44,1,2260,43
a682c4c961d6940adedc55b57f40235bcc8f59d6,org.apache.tika.parser.microsoft,3,0,2263,3
98365924bf5b7ec36b8317809f82855e0f9e17b9,org.apache.tika.parser.microsoft,40,1,2302,39
fb8a540025c7ca5a3947a27e74372fc904fb62ba,org.apache.tika.parser.microsoft,5,1,2306,4
3b9fbf9f468dd4db2018cfc4e784859c630cd994,org.apache.tika.parser.microsoft,24,9,2321,15
c80eee31e10872648a1d23fefc8e13bb3b0e65a4,org.apache.tika.parser.microsoft,8,13,2316,-5
af7df6bfaedc6b097a91eda6c789e5ee576401f6,org.apache.tika.parser.microsoft,12,0,2328,12
e2f5b4c67362e2295f6baf25152d0b352d2d1e3e,org.apache.tika.parser.microsoft,56,48,2336,8
773b46eb2bb661a6e23e17e2e6e403dfc49ff72c,org.apache.tika.parser.microsoft,204,162,2378,42
25f7a4d5dac3b7d4bebaed41ef43bf37d1e86814,org.apache.tika.parser.microsoft,3,5,2376,-2
2e976ca42e1beae14a706e9461f59e078f4d3704,org.apache.tika.parser.microsoft,4,0,2380,4
1ef02dba54362fa2fec5798c7aa79d71500a4f96,org.apache.tika.parser.microsoft,3,0,2383,3
6673d51674946be52905ad5b448ba2051092fe19,org.apache.tika.parser.microsoft,19,27,2375,-8
1a7dfa176b588047b54a2cb8798365aaf41a9ebd,org.apache.tika.parser.microsoft,9,0,2384,9
17529470f534107f17da6f5632d40c857f8886ee,org.apache.tika.parser.microsoft,6,2,2388,4
1b01e4f1d943437f29f414dd75a3fa52a05e8d67,org.apache.tika.parser.microsoft,20,1,2407,19
39a1bac909c86b520467ab9705f56585d03815e9,org.apache.tika.parser.microsoft,6,10,2403,-4
f05edfe4120445fc93dd781e9daa85a5c371a26d,org.apache.tika.parser.microsoft,97,0,2500,97
00801cbcc44f7c2e8e8fbc00d8d1b21c687331d3,org.apache.tika.parser.microsoft,2,0,2502,2
e735a659560602a1372c5aa64b3ee2475f0d1a67,org.apache.tika.parser.microsoft,16,1,2517,15
a78309d0739614ded08803b688ba9683bada270a,org.apache.tika.parser.microsoft,79,100,2496,-21
513dbdb28e0a3f7311e302646dc64bd2f0f3389d,org.apache.tika.parser.microsoft,2,1,2497,1
82ddc5381b8a2127e66828dd1faa0b469aa354f0,org.apache.tika.parser.microsoft,6,3,2500,3
b73dccb6bc47d33bdb6f1e51b723c7ef6bf3e1a3,org.apache.tika.parser.microsoft,33,4,2529,29
4287c50ce36dd48ec9ec99bbd66b73ee594af889,org.apache.tika.parser.microsoft,2,1,2530,1
50437f30e0a6c6969be162dc1e768ab061e67dac,org.apache.tika.parser.microsoft,29,1,2558,28
60711a9496a6387c125f8138b3b34a799a3f4c94,org.apache.tika.parser.microsoft,12,12,2558,0
ce78a8197fd7275dfcfbf3f36c914fd04c37cbb6,org.apache.tika.parser.microsoft,4,33,2529,-29
ac13e8e051494a19d5a311fbbe8a5210fd7196e1,org.apache.tika.parser.microsoft,2,7,2524,-5
b21fa6a110ccf987e1c46980b0d7db5d869bedfe,org.apache.tika.parser.microsoft,7,16,2515,-9
3d6dbb3e6e567eac8191e408b3de47413301da94,org.apache.tika.parser.microsoft,23,1,2537,22
75d487d306d75995484f1d010ab7e712dd2026eb,org.apache.tika.parser.microsoft,3,0,2540,3
57a99d012bc43d04ded8e7d88e056680542b405f,org.apache.tika.parser.microsoft,129,8,2661,121
b20beb604d191010793eded2398cba985312ca6a,org.apache.tika.parser.microsoft,8,7,2662,1
9e22f46f2403b89dbc8454cefb8b83881f437419,org.apache.tika.parser.microsoft,51,2,2711,49
022f18cecf52a0d653d5cba800ae1d6d3c2c294b,org.apache.tika.parser.microsoft,98,2,2807,96
b754b456c3871c453466ff06f60eedf433547eaa,org.apache.tika.parser.microsoft,6,0,2813,6
dc9ffcc36bf27b2feaa066bcf950e87847bb4bf7,org.apache.tika.parser.microsoft,12,2,2823,10
61532805e1d21bf58ddf6a914c58dd8d8dd9f050,org.apache.tika.parser.microsoft,56,21,2858,35
fdec3f36c00edd7e8c466661626330efb8272b75,org.apache.tika.parser.microsoft,0,1,2857,-1
89dc4d725fc4a1dd3406c462bb0e2b8575c5d34f,org.apache.tika.parser.microsoft,45,28,2874,17
923ef5d6b2101a7500955b9709967c7277ff5674,org.apache.tika.parser.microsoft,44,41,2877,3
c5084471e00852abbeb9e4986f2a391f7a827d44,org.apache.tika.parser.microsoft,14,2,2889,12
328b935c08b61bf785ec99952c687f04f7cf989f,org.apache.tika.parser.microsoft,35,19,2905,16
07a1590839bff6f16ac19b031a26e128141e19a2,org.apache.tika.parser.microsoft,76,53,2928,23
218352a1ce7de0881416eff741d832a1abc51f07,org.apache.tika.parser.microsoft,94,7,3015,87
f28f04af7e60ffc04550030c0c99e8c7dd931442,org.apache.tika.parser.microsoft,29,7,3037,22
7d89a5e455686a945f2e3302f0d201e5e6c4a985,org.apache.tika.parser.microsoft,5,11,3031,-6
efdb4679cb28841da7ba9d8e755596602b630893,org.apache.tika.parser.microsoft,2,0,3033,2
c36e5a0461b66a7941156dd9ee502c73aa0ee28c,org.apache.tika.parser.microsoft,8,0,3041,8
609efd4ce56f82677ff37b537ee9966cdae6ecc9,org.apache.tika.parser.microsoft,36,0,3077,36
0ce025c5cf0ab44a87bc56835e34803827f74b97,org.apache.tika.parser.microsoft,18,3,3092,15
acdb2b0ea9082dad8120431ebbf34e68b76aafe2,org.apache.tika.parser.microsoft,14,9,3097,5
a2ddd8cffdb3c69d5e8fbfec24a939ab7c3f3bed,org.apache.tika.parser.microsoft,10,1,3106,9
1d637c8e872ada489b3e928b854be0959ed0a0c4,org.apache.tika.parser.microsoft,1,10,3097,-9
363ee3bf4604a36515df8deb49c520bc3a488184,org.apache.tika.parser.microsoft,10,1,3106,9
963100eb1806048809b1fb2cb5076afdd640cdfa,org.apache.tika.parser.microsoft,48,67,3087,-19
51a7c9ccacde4f0a40d3f3a0a0c7b2d270d22684,org.apache.tika.parser.microsoft,11,13,3085,-2
ab9f799ae4a3eec42e00a109ca3171cbdf7b6cd0,org.apache.tika.parser.microsoft,21,1,3105,20
2052fc98acca935fa065ffdca302bc84cfe60ac9,org.apache.tika.parser.microsoft,56,2,3159,54
452b6e6bff345e4cf01cbfcb763b1c62db8ee83e,org.apache.tika.parser.microsoft,6,4,3161,2
d23cd385c6aad017e3c2be4c064a2043971c3153,org.apache.tika.parser.microsoft,27,0,3188,27
6d8ac09861509cfc91763a99158dfb9025690a4e,org.apache.tika.parser.microsoft,10,4,3194,6
2b8fdb1937045d194a23b56e2aea0a8bc17a665b,org.apache.tika.parser.microsoft,0,6,3188,-6
14aa5bfbab763cb00677d89b7e6cc0077c8a6ca7,org.apache.tika.parser.microsoft,7,0,3195,7
8b82be859eca418bce7aa3a4687917c7385d4397,org.apache.tika.parser.microsoft,1,1,3195,0
32431aa6b4da155fd4e36baf10058c873097babd,org.apache.tika.parser.microsoft,6,2,3199,4
146dcda13c4f3ead6c19d7861e89a769685321fd,org.apache.tika.parser.microsoft,26,2,3223,24
2ac245fc84207c6d61fd6ca9195d24eb91747fe9,org.apache.tika.parser.microsoft,10,0,3233,10
20ab62de27c7e34d1c09b3cd0a14c0e32e59994b,org.apache.tika.parser.microsoft,42,12,3263,30
23a7f5c05121c486f6ee9e484adcf10cc01f8d98,org.apache.tika.parser.microsoft,4,6,3261,-2
9227e9f3d5090be28e28639ab92732c5be0507cf,org.apache.tika.parser.microsoft,8,7,3262,1
2a36fcd63ddd3234b7f34e6814972bb62aeb4bc9,org.apache.tika.parser.microsoft,100,20,3342,80
f570a3b5987f8c49a97528dc7f8ac6a53c58238c,org.apache.tika.parser.microsoft,21,3,3360,18
17ef0deae2372bdb46cce2052425fec02badb6d7,org.apache.tika.parser.microsoft,25,0,3385,25
2aaec12dbd492d716aab53f7ee32bdb247404c35,org.apache.tika.parser.microsoft,58,16,3427,42
7b2c4e87c822c98e334acc06a7fef8b7f89d6ccd,org.apache.tika.parser.microsoft,47,0,3474,47
beff3947978d4573e35a40a7b0ad8fb7ec89a2f6,org.apache.tika.parser.microsoft,65,61,3478,4
398f50f51fb363b9aac60ec50f54d977089ef957,org.apache.tika.parser.microsoft,3,15,3466,-12
8e0c444b1f1bf61215a298c2b782b5cb451f9cde,org.apache.tika.parser.microsoft,23,7,3482,16
424c0ebd503900bdff481e059a3a326dc7add814,org.apache.tika.parser.microsoft,1,1,3482,0
628842dc89c938f5780b3926cfcdcf12fff42ee6,org.apache.tika.parser.microsoft,0,1,3481,-1
79211cc7a400f3b0b066f0a6401dee1c2fa9c90e,org.apache.tika.parser.microsoft,4,5,3480,-1
51377f1380d71e1af063dcd8d3538cd3e9d294c7,org.apache.tika.parser.microsoft,4,4,3480,0
3b74476bd0a65a20d09a3da709cfe7ef1d6ef266,org.apache.tika.parser.microsoft,2,2,3480,0
41530451deca7dff7478eec8351df537b6942875,org.apache.tika.parser.microsoft,8,1,3487,7
2cf27a74c57814692655f7f6c44754a8571a44c9,org.apache.tika.parser.microsoft,4,4,3487,0
85137c5c3d3bd867769e3028b50e8907e8054799,org.apache.tika.parser.microsoft,1,7,3481,-6
be7476ed1e86a7bc36b73ef5b780dc218e5847ab,org.apache.tika.parser.microsoft,38,37,3482,1
62979fad289bbbb27a7068b171ec2a972f1049b7,org.apache.tika.parser.microsoft,3,4,3481,-1
e27454a2d652fb4392d2824b9a1500e8be8628fc,org.apache.tika.parser.microsoft,8,6,3483,2
080b03607aba6275dbede13fc15e9c1bd525f410,org.apache.tika.parser.microsoft,3,2,3484,1
6cc0e11b91ee5ebe97ea91fc50a76074f45829c2,org.apache.tika.parser.microsoft,5,9,3480,-4
7e6448348853234fe76c732ffeccb76200fe464c,org.apache.tika.parser.microsoft,19,2,3497,17
50dcb7b3e93ad26b006de513dcd51fef4a7d67f4,org.apache.tika.parser.microsoft,2,2,3497,0
1bafbb815913089847ed8689e47b958c44fd92c3,org.apache.tika.parser.microsoft,8,3,3502,5
2fedbba444b3ec35944e6a55a6771dd5cd93cf9f,org.apache.tika.parser.microsoft,4,3,3503,1
1bdd91ba9bd8b8f853c77334792461151a37b529,org.apache.tika.parser.microsoft,49,1,3551,48
64419f7215c3053665bb9f9342d8326944f42ad0,org.apache.tika.parser.microsoft,10,3,3558,7
ccd0c4b5202c8fa5511ecb885add5ef892cb0807,org.apache.tika.parser.microsoft,1,0,3559,1
2129abf1853945c241c9d9d0faee8a2c643ea533,org.apache.tika.parser.microsoft,83,6,3636,77
46b321f798bdafeb390bdf1a23ae665c3fad3fec,org.apache.tika.parser.microsoft,98,0,3734,98
d398c71910f797b073e57e1b04e3856a52b15c24,org.apache.tika.parser.microsoft,121,1,3854,120
e76299d5a07d64586bd1d4f58470397f914917b2,org.apache.tika.parser.microsoft,91,40,3905,51
89eea5fd18f92e8280abeeccb09556e3dde271f3,org.apache.tika.parser.microsoft,33,33,3905,0
892f3a8b1e44efdf86ec9aed0887de7afcbf01ea,org.apache.tika.parser.microsoft,2,1,3906,1
990c0c2096fdabec508371cbf96f9e77bd61f12d,org.apache.tika.parser.microsoft,59,4,3961,55
a7b50cac3293308f5a79d77664d0ec48d466163c,org.apache.tika.parser.microsoft,533,4,4490,529
5239ee7922c52a6a5281f3671ee9b31f7707f5bb,org.apache.tika.parser.microsoft,2262,2237,4515,25
826467e20587fcabf3d292c192d077b4fdee413f,org.apache.tika.parser.microsoft,23,6,4532,17
2a47d9aa340d529f027c94f3c233645fb2f8bf7e,org.apache.tika.parser.microsoft,502,0,5034,502
9688c77128e5c3d53c1eeb4e72db62ff10dfafda,org.apache.tika.parser.microsoft,48,0,5082,48
320b2890038dfcb9191ba856c0e84e368851d24e,org.apache.tika.parser.microsoft,8,2,5088,6
898f300c87b629590b2bd3bccca5ce0c05330438,org.apache.tika.parser.microsoft,49,7,5130,42
4dcfb74cf702aa88a94f58ca79ede313dfb45852,org.apache.tika.parser.microsoft,1,1,5130,0
c11eee52587227fa4579436d6f408a4758683520,org.apache.tika.parser.microsoft,142,18,5254,124
9c04fa667610016da957cf3ff2afb6d7231b02c8,org.apache.tika.parser.microsoft,118,2,5370,116
19eb4448304abff6322d830ccee7ed868d443d71,org.apache.tika.parser.microsoft,11,8,5373,3
d5981c7079c23c58dbb91aebce30de5498f51b8a,org.apache.tika.parser.microsoft,1,1,5373,0
8938fdfa93f8c0647e547e8a04a187fbb5a32603,org.apache.tika.parser.microsoft,77,210,5240,-133
e7a3a49561cc1f9ffa4cd34307005f559dcefe19,org.apache.tika.parser.microsoft,7,0,5247,7
285a462b0404aeee36a856f445cb08fdce475035,org.apache.tika.parser.microsoft,79,68,5258,11
5d50c2e9391a9f31ea435724aef9e0bb73624984,org.apache.tika.parser.microsoft,0,1,5257,-1
8d8823ad9e8281cf79c492d714ae2a815644f763,org.apache.tika.parser.microsoft,46,6,5297,40
2a560ebd11beff94f105b7adab4a367f9388527a,org.apache.tika.parser.microsoft,57,46,5308,11
5a7027a1d2a82895b49d4131ef20f3e59e417712,org.apache.tika.parser.microsoft,52,24,5336,28
52b82bddef7c7ae8a430c9871594295e71882055,org.apache.tika.parser.microsoft,11,1,5346,10
7d43bd7c5f55afc9ce46d4e3bdea71102d49aa9d,org.apache.tika.parser.microsoft,5,5,5346,0
b4b5316edfa15d112a3a59e9dae4f9c8d125e306,org.apache.tika.parser.microsoft,12,2,5356,10
25cee54499126de2b90f6bd5bde8de470b422349,org.apache.tika.parser.microsoft,2,2,5356,0
559557aa311c6dd81f26d8142a6df6f6fc55513f,org.apache.tika.parser.microsoft,51,1,5406,50
f054bcd1a0a57a730ebc53e7a2cfd4215a7526fb,org.apache.tika.parser.microsoft,53,3,5456,50
e9206475e683c35b09810a857ddd7bdbfa8f60fb,org.apache.tika.parser.microsoft,42,21,5477,21
da1fe243ace68cc2b5c4bde022113233ad95ea15,org.apache.tika.parser.microsoft,42,21,5498,21
dab10395ab59a36be52529d3afa7ed370ce60eef,org.apache.tika.parser.microsoft,8,3,5503,5
80b27e6d843d221de87591d34632e546c0d23b1a,org.apache.tika.parser.microsoft,8,3,5508,5
2caf3da7cfeca675530fa86c6f76c451a433e732,org.apache.tika.parser.microsoft,8,3,5513,5
69852e4cb55d34e6513e0b66af7d75cb1b1408ba,org.apache.tika.parser.microsoft,35,3,5545,32
bb78082b0028b57a5bf1ae30858dda6aebeacf63,org.apache.tika.parser.microsoft,2,4,5543,-2
bc0b1f7f7e0b854a119779fc3f806e0d9490c08a,org.apache.tika.parser.microsoft,653,0,6196,653
e780d56652d48dd0f50b4e62a58153e95f055022,org.apache.tika.parser.microsoft,735,26,6905,709
01a9b6db5ac20a63f2b9de9c15de1b12ee2bde06,org.apache.tika.parser.microsoft,112,0,7017,112
f7fe685e44d9cbc2ea9391723c79753d77a0525c,org.apache.tika.parser.microsoft,1,1,7017,0
592ae6a6cda88ed33c667e1b9211cd7c393710c4,org.apache.tika.parser.microsoft,2,2,7017,0
d9dcd59ae01c6ae2c8bded94bc9b04d795face9e,org.apache.tika.parser.microsoft,112,0,7129,112
027625dd71fe9f5c33a546b7395aee744adb2ae0,org.apache.tika.parser.microsoft,81,0,7210,81
7ae760e29ad3ed5874f7f50c27c6f850ab1d8025,org.apache.tika.parser.microsoft,152,36,7326,116
2031de70c117fdabf793008fe22dd9c97c82d2c9,org.apache.tika.parser.microsoft,28,28,7326,0
b6d55ae345db933d69cc9a7d290e3f8ca567b5a9,org.apache.tika.parser.microsoft,91,14,7403,77
7cc610e1b3f164fe9de00b1a35e60fd00a69bb46,org.apache.tika.parser.microsoft,48,10,7441,38
52f04bea6075003540a9d8b57768f814f908c442,org.apache.tika.parser.microsoft,2,2,7441,0
a57d8364c378778a14b205e0528e43a1f9fac417,org.apache.tika.parser.microsoft,21,1,7461,20
23a11eff3018977f031cce663bb412678f08ba89,org.apache.tika.parser.microsoft,6,6,7461,0
fe559b80bcad1f107904ca7a89724a26ea2921a1,org.apache.tika.parser.microsoft,1064,18,8507,1046
a383567c2c947603c4c7aa12d3578d771bb58413,org.apache.tika.parser.microsoft,174,1,8680,173
85e53850026aadce49bc99c1ef2de9d5c7be0451,org.apache.tika.parser.microsoft,8,0,8688,8
80efc84b675c8defa5e86b01b85e1dabc84d32f5,org.apache.tika.parser.microsoft,30,1,8717,29
d50a69361bd0196fb2595313cb47222f61701ba4,org.apache.tika.parser.microsoft,212,2,8927,210
cc6f6dcc8fed2826ae8093b7a4aed0ddee74dc40,org.apache.tika.parser.microsoft,36,19,8944,17
2ae7206d9c99fb553314cff21bb155d4e6f06d12,org.apache.tika.parser.microsoft,88,0,9032,88
8a45f67a2e3641b08fcfb5e2283e4a43ff86f3cd,org.apache.tika.parser.microsoft,29,21,9040,8
feac58b6f74156086113bf08bbfe9feda1c14b79,org.apache.tika.parser.microsoft,6,7,9039,-1
8e819c3caf3ff3b0492f600b4193d1b3ee74f51b,org.apache.tika.parser.microsoft,101,1,9139,100
bc7216ff70d87c71c5817cda89d990d4f7075ccf,org.apache.tika.parser.microsoft,5,0,9144,5
7ca105ef5716a23300da0b8939fcfa249b798532,org.apache.tika.parser.microsoft,16,2,9158,14
75fa1386b95ccf1bc7fb9a9f60811636baace05e,org.apache.tika.parser.microsoft,14,4,9168,10
47ba703d6e682147fa3e6abb9a9cc756c7fc2760,org.apache.tika.parser.microsoft,46,73,9141,-27
81fad8c97e60a3de7d926dc4ce10cbd235549583,org.apache.tika.parser.microsoft,38,0,9179,38
d19e4725ff0549597f9156bb0c1e7759f6ce08d9,org.apache.tika.parser.microsoft,154,2,9331,152
fe20ecd83ea43e5ec6ad0e9fded9d803cb011251,org.apache.tika.parser.microsoft,22,2,9351,20
09931fe4227478516bf067bbb08056f49a506dfa,org.apache.tika.parser.microsoft,7,1,9357,6
894301307da5167c95585688f9448d3050f53aaa,org.apache.tika.parser.microsoft,27,0,9384,27
90cdf1f6a844e0d0541167bc0364bb3963f93b2d,org.apache.tika.parser.microsoft,22,1,9405,21
c62410443ca88f8118f50e6ee521a13a22f64729,org.apache.tika.parser.microsoft,14,0,9419,14
84a37209e1c6e27491c9e828799919bc32f8787e,org.apache.tika.parser.microsoft,7,2,9424,5
8eb7d352f6b7a488bfdca172a0707cb514157a34,org.apache.tika.parser.microsoft,117,41,9500,76
c9639bd19d23ecf5b1a1c3907d6ed1874d84d736,org.apache.tika.parser.microsoft,16,0,9516,16
b9474f14b5af9b50b187028bac232b996543bbb3,org.apache.tika.parser.microsoft,1,1,9516,0
e6c0082e41143a01f0bf646a8a8b6c06a85ca239,org.apache.tika.parser.microsoft,2,2,9516,0
90bf4f6e4c645240b36ded6973eb64961312fc0a,org.apache.tika.parser.microsoft,2,2,9516,0
7afcfc702e3097f652a0ea21c368f7632d2abf3e,org.apache.tika.parser.microsoft,4,4,9516,0
3c0cd647571d23665056de9adcaf5d58dc087fb9,org.apache.tika.parser.microsoft,7,2,9521,5
0d54f07facb23219a11f763e4c56cd40ec2bcd77,org.apache.tika.parser.microsoft,9,11,9519,-2
bc3b26369ffbeff83a6e27f57a564089661e5030,org.apache.tika.parser.microsoft,4,0,9523,4
b9befb4272cf8b2bda3b3ea25b0511bbabfdeded,org.apache.tika.parser.microsoft,369,0,9892,369
1c873399ee30af9912a7210e4ced8168f659db04,org.apache.tika.parser.microsoft,7,5,9894,2
e3a50ba30ad5ccee721401ceb20464cb327de17c,org.apache.tika.parser.microsoft,23,3,9914,20
6d022be03b5423f6c036e1aa45e4ce02a9678462,org.apache.tika.parser.microsoft,6,6,9914,0
b8fd7ee82a1ffeb7e41358bfaa7c5d003e6c255c,org.apache.tika.parser.microsoft,5,0,9919,5
87745dfd3dae1647e54c88d8d928a5d30ee335e6,org.apache.tika.parser.microsoft,1,1,9919,0
c3383b005f9879019a9a18e6eae362e3498acf54,org.apache.tika.parser.microsoft,46,0,9965,46
745f13cbd0dd2143d3a95e414f399bd73b0e47ab,org.apache.tika.parser.microsoft,113,30,10048,83
2234f3312f3ddca02f2899138157e1f5fdef92ba,org.apache.tika.parser.microsoft,37,13,10072,24
fecb19a98f278166870b2aef4c9a5bc82a1f1a2c,org.apache.tika.parser.microsoft,12,11,10073,1
b2f3eafc49221cd099f0ad9126cf90ad5535bdaf,org.apache.tika.parser.microsoft,149,72,10150,77
e8ee4ce7fbdc4fd8d0a496731f2b0a481687b72f,org.apache.tika.parser.microsoft,4,11,10143,-7
256a2814f2ee3e7d5f5d9b24447806d6204e4ae0,org.apache.tika.parser.microsoft,2,2,10143,0
0d8f030f02830a39e004fbfbd6989128ec2047d7,org.apache.tika.parser.microsoft,4,11,10136,-7
19c0e916982174da20ee98196db840c7465471eb,org.apache.tika.parser.microsoft,123,6,10253,117
5877c4c8702a10a76b6c3ee59fbae7daf3c9b062,org.apache.tika.parser.microsoft,2,2,10253,0
dbdead5c1ab375cc615a1db3254be0aac47e209b,org.apache.tika.parser.microsoft,123,6,10370,117
67612b8f805ad5d1085db14922d3b3b6ddce19bf,org.apache.tika.parser.microsoft,0,38,10332,-38
aa4954fb44f707779693faea785acc219739ccd5,org.apache.tika.parser.microsoft,24,0,10356,24
562e4faf95bc85b3ab2290055860d3e075a66451,org.apache.tika.parser.microsoft,39,8,10387,31
d64a32c63f376b9e003a4512adfec05414d4dfe6,org.apache.tika.parser.microsoft,51,23,10415,28
104ca3ef6480528ac22c1426d3a3ecfb184d5161,org.apache.tika.parser.microsoft,5,5,10415,0
70d2455c4ff7c54afe6762d5b50653b8de06f2b2,org.apache.tika.parser.microsoft,68,51,10432,17
90cbe005ed901e1791716c8d7d67baecc3a54c56,org.apache.tika.parser.microsoft,1,1,10432,0
e56e2b2915e8cebcf97c69cdcb3ecff861434f61,org.apache.tika.parser.microsoft,2784,216,13000,2568
6b174ecbb70d1236bdb9886f86bf94f51d3dd881,org.apache.tika.parser.microsoft,192,58,13134,134
48580b0dd9bae39d8a32192bc2b8c3e4177a84be,org.apache.tika.parser.microsoft,3,1,13136,2
b2fc478e99b9814fde747d8f8eef03e054fb4d25,org.apache.tika.parser.microsoft,16,0,13152,16
5cbaed87235c2cee49c9d4fa15d84158d000e986,org.apache.tika.parser.microsoft,85,17,13220,68
134cb3812aba88152f665c1d14ff65092f21d051,org.apache.tika.parser.microsoft,104,18,13306,86
ebb4bc6d7bf82fe618b7a4b5f4e9b4278b96c0d2,org.apache.tika.parser.microsoft,85,17,13374,68
95c515db2f303db049c79a7bd0c260ec559186b1,org.apache.tika.parser.microsoft,42,6,13410,36
b618984cc78df5696886404c6579d2bad71e1bb8,org.apache.tika.parser.microsoft,146,24,13532,122
8eef0562f82088db3bb66d17d8eb28188468112e,org.apache.tika.parser.microsoft,42,6,13568,36
cb7b84a48aa7f500c08733b06fc78e6c1f0bba14,org.apache.tika.parser.microsoft,9,0,13577,9
621ded89fd909380ff5c3d2c5d13d73dd6e5b982,org.apache.tika.parser.microsoft,8,10,13575,-2
4ed69a8fa30783d593b9cb60a30414abb5480a3f,org.apache.tika.parser.microsoft,8,1,13582,7
2e7a4f5a976ad07284b83b9bc0e61ce63349cac7,org.apache.tika.parser.microsoft,25,11,13596,14
55caab732574518e8676ec9718da05bde1c1ce8f,org.apache.tika.parser.microsoft,7,13,13590,-6
08d09a559c36a7f5f0e96887ca3e0ea8eb79a321,org.apache.tika.parser.microsoft,17,18,13589,-1
9687f08f38d2b634af7d334e35e809182096f1c1,org.apache.tika.parser.microsoft,1,4,13586,-3
898946e4aee581e57c43f4692fb95d6c0d1e336b,org.apache.tika.parser.microsoft,7,13,13580,-6
71a80c99e9052d7ad918b18d4714e05fb32ca288,org.apache.tika.parser.microsoft,17,18,13579,-1
12cce58747b7d7d989038195ad39c5c69e75a8a6,org.apache.tika.parser.microsoft,17,18,13578,-1
13ebacfc3ee564b60bef50b20312a866dc18937b,org.apache.tika.parser.microsoft,2,4,13576,-2
f3acaed38361c35d940ce2742a18b1eec9d7c4f2,org.apache.tika.parser.microsoft,1,0,13577,1
f53a2f28611bee60ac00e3b6717972751bcb3a5e,org.apache.tika.parser.microsoft,1,1,13577,0
30b27aba5c2149978ecf9395b0107011dfee3ff1,org.apache.tika.parser.microsoft,1,1,13577,0
ef12f7d87ea52f1a3271f37472ba185e616ca125,org.apache.tika.parser.microsoft,1,1,13577,0
a51add2afe475ba8d3fb5847c97f52b1eb71deea,org.apache.tika.parser.microsoft,6,5,13578,1
4e03f90cf0a20375819f33371ec094386a744f36,org.apache.tika.parser.microsoft,2,1,13579,1
b422edafa74dc2d9efc4c8d01d59fd468e915840,org.apache.tika.parser.microsoft,2,1,13580,1
3621ee4abde21f66ebab200ba2788e160b8df65d,org.apache.tika.parser.microsoft,85,41,13624,44
bf03dd4a3b37033f2efb7eece470a0477b6964ab,org.apache.tika.parser.microsoft,12,2,13634,10
921949cd239f67fce97d0f9ee004a72e15f3f1c1,org.apache.tika.parser.microsoft,12,2,13644,10
87033d62fd2c55a47c858a949d93b35725ff2d2b,org.apache.tika.parser.microsoft,5,0,13649,5
74574e38cb2f53395c185742928052d17b181b5a,org.apache.tika.parser.microsoft,107,4,13752,103
5638ebc0db0b88341ba663d5ba12eebbe2925240,org.apache.tika.parser.microsoft,10,0,13762,10
21c0f373e0a9bcf82e3e53c886c45f448b50df76,org.apache.tika.parser.microsoft,3,0,13765,3
582083e003efe45bd9e2e7a624a4177c9f1ddc50,org.apache.tika.parser.microsoft,3,0,13768,3
d1a8bff9faacb828a1039f7cc2c7f9e1f1d5e3fd,org.apache.tika.parser.microsoft,8,0,13776,8
7dd38d5500c539328e2b0a083e1998a28e680539,org.apache.tika.parser.microsoft,21,0,13797,21
f16bd0e2dc8b86fc3cc58b9a80dc7544d549651d,org.apache.tika.parser.microsoft,2,2,13797,0
ad23d84f88abe6e540e989c988142f1ca0c876a7,org.apache.tika.parser.microsoft,11,1,13807,10
b5f5403fb150f2a290fe1cfa10a6fe572b1dd50a,org.apache.tika.parser.microsoft,24,3,13828,21
ff481b25dd7f141f55907ce194b9bc2c77fc7069,org.apache.tika.parser.microsoft,220,45,14003,175
93cbed6df993ef01e59c55b86449b664e9052cae,org.apache.tika.parser.microsoft,11,0,14014,11
10a8eec119c7a77be76000b30aaffb96a552cc44,org.apache.tika.parser.microsoft,54,83,13985,-29
e6e3b8817053e981f3843f1d3b7055b4ae30ed73,org.apache.tika.parser.microsoft,54,83,13956,-29
4c510d6a9910044825c6ee8df87c419a3370ab4e,org.apache.tika.parser.microsoft,83,1,14038,82
f8b1d9a87c0954c7efb32606d2cce380fddc82a1,org.apache.tika.parser.microsoft,15,1,14052,14
16a8ff95290027682762932b6b29463790fe5b6d,org.apache.tika.parser.microsoft,15,1,14066,14
c56c7c41a6c51e4cd4dac78b693bd883f1329264,org.apache.tika.parser.microsoft,0,1,14065,-1
1a92e70ca8e027ef24fb57ee1098c49ecdd0e2af,org.apache.tika.parser.microsoft,0,1,14064,-1
cadeb1d762ca306a27b0075595473d9c897b4a6a,org.apache.tika.parser.microsoft,0,1,14063,-1
8ecfeeff86e991fa9b6c3fa12b89ec96aef00684,org.apache.tika.parser.microsoft,18,12,14069,6
50f8591c6c87b756d6d8881c95f9794c51ffa240,org.apache.tika.parser.microsoft,2,2,14069,0
acb49581c9be20f0c880400403caa0ea1b30b508,org.apache.tika.parser.microsoft,13,2,14080,11
7a9b17f478c867c7df5516b4ebb2ce3bf8b0aa36,org.apache.tika.parser.microsoft,23,1,14102,22
742e60e20363aa66db992df4d1cae26b18060f45,org.apache.tika.parser.microsoft,36,3,14135,33
5f05b511d7d1184f6f25a2b644b615c4f21b8e68,org.apache.tika.parser.microsoft,7,6,14136,1
a1e42a0659ba33e90cb1bba0a0a10eeb97d4fac7,org.apache.tika.parser.microsoft,15,1,14150,14
348b87e7f41b79ff115e17d9c91d2dad63a57c15,org.apache.tika.parser.microsoft,38,13,14175,25
64bb30844e0caafff1c9ebac7c8b0c5b512ea81e,org.apache.tika.parser.microsoft,6,1,14180,5
8110645cc4b181fefd9663b1592213e79a298b0e,org.apache.tika.parser.microsoft,2,0,14182,2
e24e6afb1c2a37be266839767115ad6adc5f8dcf,org.apache.tika.parser.microsoft,4,7,14179,-3
b10c24dc8283401c9ef93b3a8535880ebfb30e6f,org.apache.tika.parser.microsoft,4,3,14180,1
e7b481dd763ff4f586a94b981281923e4604010a,org.apache.tika.parser.microsoft,4,3,14181,1
ba436227b987199717b5b94689d10c7b0d1deb14,org.apache.tika.parser.microsoft,14,8,14187,6
94560199e88d3a490740ba93dbbd4c2a0adccae6,org.apache.tika.parser.microsoft,14,8,14193,6
7e477e3ae6eaf819f42be2d7eb43aaef89002e4c,org.apache.tika.parser.microsoft,1,1,14193,0
da26f02bf60ea3ef59bfa5b67930925d8dcd2e77,org.apache.tika.parser.microsoft,14,3,14204,11
01c53eaa6d709972b03735574aa58dc0abcdc51c,org.apache.tika.parser.microsoft,1152,61,15295,1091
5a4a0eecf61d7ced2a708d0184df5179c125dd4b,org.apache.tika.parser.microsoft,3,3,15295,0
927c224cde7a7358325c349a3c439766e8ad2988,org.apache.tika.parser.microsoft,2,7,15290,-5
0b2575b272c727f7c20cc58149dfec9a258ac799,org.apache.tika.parser.microsoft,240,118,15412,122
86e997510b44f12dc9f90a68aaf583d5d3912892,org.apache.tika.parser.microsoft,0,76,15336,-76
10a48b7a0077fbe627d3a0111f92910228d05d77,org.apache.tika.parser.microsoft,10,1,15345,9
6ccedbadd4f79d7888eabfcd3a740000ab85e168,org.apache.tika.parser.microsoft,10,1,15354,9
27454e364525a67deee0673cf91dbb2f090b0b41,org.apache.tika.parser.microsoft,2,4,15352,-2
93a2c2740edd803cba0273dec92e69c1f2a60dbe,org.apache.tika.parser.microsoft,4,1,15355,3
888f51fe5ba7d735fecfa7d2aa4acb6fe8d69508,org.apache.tika.parser.microsoft,1,1017,14339,-1016
baf0bb9c9c9fcc433c84b6047f78611af6675283,org.apache.tika.parser.microsoft,21,9,14351,12
64877c5a6187ecd13e098e99edc97a1f6dc09112,org.apache.tika.parser.microsoft,18,4,14365,14
cf5b8123769cb094163331a1395487c1f874c296,org.apache.tika.parser.microsoft,18,4,14379,14
919768a649ebb4585ce45cf0f0a37ee0bb371355,org.apache.tika.parser.microsoft,83,0,14462,83
d7006b8cebdb6e97ad14e9536021cc70e01b3923,org.apache.tika.parser.microsoft,1,5,14458,-4
90e31600755c5abb67e247ea9112203bc9e9561b,org.apache.tika.parser.microsoft,19,89,14388,-70
20848961fae9853aa2afa7957f6421c57fe09272,org.apache.tika.parser.microsoft,16,1,14403,15
e1ed5ccd813de86fedb12d77da41d58970b9f52c,org.apache.tika.parser.microsoft,95,86,14412,9
68d2faa070a4650da67ab683f616f4c6cab1657d,org.apache.tika.parser.microsoft,16,0,14428,16
0d9dacdc6ca153572a7570f7934ec82f1c2ea92e,org.apache.tika.parser.microsoft,5,4,14429,1
22ff7564f2641ba195f192d7c59e9df4a3a10747,org.apache.tika.parser.microsoft,39,4,14464,35
07ef8500cf9489b23f6b38f4f98392a254c23352,org.apache.tika.parser.microsoft,65,44,14485,21
313ef8b53ad3bba3f0910bcfb25db683ba6ba209,org.apache.tika.parser.microsoft,17,31,14471,-14
f6a57491fa1de007462df2b08f60cbe094361e12,org.apache.tika.parser.microsoft,4,2,14473,2
6678861a32c85890bb7e20ffca3ce6ca807c3c92,org.apache.tika.parser.microsoft,13,0,14486,13
7028e7b765c1bd36652bda96d69eb2ae9a7757d8,org.apache.tika.parser.microsoft,12,3,14495,9
c99a7f2c36f03fd20f5d87cf1edb19138a0a8e1d,org.apache.tika.parser.microsoft,10,5,14500,5
1ebc5f83d74969287616d0200b5a3f6a79785965,org.apache.tika.parser.microsoft,52,13,14539,39
582602aed881b81b3350071808e97addb4222123,org.apache.tika.parser.microsoft,6,0,14545,6
0cdbbcb45e2fde2963bcf65d485cd7c414779ae9,org.apache.tika.parser.microsoft,95,11,14629,84
7e68c3661843309f76a290e1889eda58ae0921f1,org.apache.tika.parser.microsoft,110,108,14631,2
b329820804bb74cc290337041eee595395e77435,org.apache.tika.parser.microsoft,2,3,14630,-1
f9104d17ad0b92b243501fdf0863b4ccdaa5e791,org.apache.tika.parser.microsoft,7548,4342,17836,3206
d4a39b4873d939553e0742487b8c84f072497c1f,org.apache.tika.parser.microsoft,97,0,17933,97
a504d7e7e8cfccbbda0d31c9362358ea4900c1ec,org.apache.tika.parser.microsoft,6,4,17935,2
b5c3485e9f1c390565ccc0abc5e4609fdab9bd0a,org.apache.tika.parser.microsoft,59,49,17945,10
f29362d91b46864a7f924c60f7cf691ac18f11b2,org.apache.tika.parser.microsoft,1,1,17945,0
7595d820633d2588234b6650ab36265a4dcdfec0,org.apache.tika.parser.microsoft,1,1,17945,0
faad4c316634880df054dc6178e18f172a132d4e,org.apache.tika.parser.microsoft,45,80,17910,-35
37f0559c28dd485557f5d66e9c0fe6cb6123b225,org.apache.tika.parser.microsoft,45,80,17875,-35
7ed64a5bd8e564bbe8fce0948a71c1db249fa2fb,org.apache.tika.parser.microsoft,3,3,17875,0
372ccd23e6399de9b5d9d93906645e1e4349ec99,org.apache.tika.parser.microsoft,2,3,17874,-1
6401ca084ac9409bf6b6c94b2fa4ff293e427133,org.apache.tika.parser.microsoft,6,6,17874,0
9ec102102119e6d398c53652e1a28c2c61600f5d,org.apache.tika.parser.microsoft,3,8,17869,-5
02bf521ba11f22d5de636c7de41fe8643497246a,org.apache.tika.parser.microsoft,34,23,17880,11
ce55ab9f9212809842629bca20259db7c2c5ef72,org.apache.tika.parser.microsoft,3,2,17881,1
8dbb5736fa92b323e270e2075b42dce458a3abd6,org.apache.tika.parser.microsoft,0,5349,12532,-5349
a43784b19f6b0955478dded71521b0491d21c90b,org.apache.tika.parser.microsoft,1205,0,13737,1205
12198666bf0cf6811613c9ae27c4a384e42875b1,org.apache.tika.parser.microsoft,4144,0,17881,4144
f9104d17ad0b92b243501fdf0863b4ccdaa5e791,org.apache.tika.parser.microsoft.chm,6981,0,6981,6981
faad4c316634880df054dc6178e18f172a132d4e,org.apache.tika.parser.microsoft.chm,3,3,6981,0
37f0559c28dd485557f5d66e9c0fe6cb6123b225,org.apache.tika.parser.microsoft.chm,3,3,6981,0
8dfee9ecff0ad4f01555abdae82d5e5e8e5c8690,org.apache.tika.parser.microsoft.chm,1,1,6981,0
49bd7d574143fde300151f70319d9cc25559e66d,org.apache.tika.parser.microsoft.chm,1,1,6981,0
f23d3777120dd86e1a5e8c1cd43f6f178f1ec956,org.apache.tika.parser.microsoft.chm,2,3,6980,-1
8dbb5736fa92b323e270e2075b42dce458a3abd6,org.apache.tika.parser.microsoft.chm,0,2924,4056,-2924
a43784b19f6b0955478dded71521b0491d21c90b,org.apache.tika.parser.microsoft.chm,674,0,4730,674
12198666bf0cf6811613c9ae27c4a384e42875b1,org.apache.tika.parser.microsoft.chm,2250,0,6980,2250
dd85c73094dc87f6f6e208278325be810761f490,org.apache.tika.parser.microsoft.chm,2,3,6979,-1
326b7d7abda238ccc181fc2acaf2271e08fe9c1b,org.apache.tika.parser.microsoft.chm,3,2,6980,1
7f65d61b4fe1f4c1d4929bbe1c456c68afd44b6c,org.apache.tika.parser.microsoft.chm,2,3,6979,-1
c85f5cc4729f1d6bd81c24bab375e89fd1037237,org.apache.tika.parser.microsoft.onenote,5879,0,5879,5879
db87546dcb4072996f349731ca877509c989c8c7,org.apache.tika.parser.microsoft.onenote,377,192,6064,185
350df7eacc266c0497a8f5aae068d90508abf3ff,org.apache.tika.parser.microsoft.onenote,16,0,6080,16
d891430da23f071625c2ae62d1def041efd15d81,org.apache.tika.parser.microsoft.onenote,53,34,6099,19
aaa9f40e3c8119f1a155e3f1eea5c2ffe7f4f26f,org.apache.tika.parser.microsoft.onenote,5,1,6103,4
a2f35a32fd989e940b70485a8f979ad92a375483,org.apache.tika.parser.microsoft.onenote,6,3,6106,3
f9104d17ad0b92b243501fdf0863b4ccdaa5e791,org.apache.tika.parser.microsoft.onenote,1019,1020,6105,-1
6401ca084ac9409bf6b6c94b2fa4ff293e427133,org.apache.tika.parser.microsoft.onenote,1,1,6105,0
8dbb5736fa92b323e270e2075b42dce458a3abd6,org.apache.tika.parser.microsoft.onenote,0,1927,4178,-1927
12198666bf0cf6811613c9ae27c4a384e42875b1,org.apache.tika.parser.microsoft.onenote,1927,0,6105,1927
8a80ee560caeff41560e9dad911a07a62340a368,org.apache.tika.parser.microsoft.ooxml,860,0,860,860
78ac6373f6251d8c78e6bbf6a0a85747f85d6461,org.apache.tika.parser.microsoft.ooxml,5,5,860,0
0236e017be19e614f34660b0db892ef00cb1a3c9,org.apache.tika.parser.microsoft.ooxml,18,13,865,5
3d8a58aa28f15e17c21158d096e24b1f65e750cf,org.apache.tika.parser.microsoft.ooxml,6,9,862,-3
3922b01361d5958a31c199e376e7a979a3a6d376,org.apache.tika.parser.microsoft.ooxml,16,7,871,9
43bb4c6322386125e58aa9276e68764b9389190e,org.apache.tika.parser.microsoft.ooxml,15,9,877,6
a68d61cc30e6508264365b7838ef34a92acbdfec,org.apache.tika.parser.microsoft.ooxml,8,7,878,1
a459b77defe9a0112bbcbf2fc69ae55a3f4dccba,org.apache.tika.parser.microsoft.ooxml,3,15,866,-12
0297f443cdd0083445d3a37ca35d8ca87a5ec1e9,org.apache.tika.parser.microsoft.ooxml,43,12,897,31
6c6c17dc1ad9fefa5f795410cce937af56b4558f,org.apache.tika.parser.microsoft.ooxml,8,1,904,7
16924c33d721758cf58dccf15ce3b2b05952f524,org.apache.tika.parser.microsoft.ooxml,3,4,903,-1
ad11aac0a56344521d33306b36f645f984173531,org.apache.tika.parser.microsoft.ooxml,3,5,901,-2
dfb6447733c45382e1b014b47b7daf027e12ae4b,org.apache.tika.parser.microsoft.ooxml,31,8,924,23
e543c5b40ec687c3ab31f7b61f3bfe953cc37b17,org.apache.tika.parser.microsoft.ooxml,80,12,992,68
5bffa845bd39af4b743a026243fcb0ab1a49e395,org.apache.tika.parser.microsoft.ooxml,14,5,1001,9
a5e95841c9999bb8350043b80ce792f9f5eacdd9,org.apache.tika.parser.microsoft.ooxml,3,12,992,-9
093a62b2a223842d596f3a7381abcb65a32554c2,org.apache.tika.parser.microsoft.ooxml,13,0,1005,13
9544c3a37ee7b679203b382ad469301d41f45436,org.apache.tika.parser.microsoft.ooxml,53,1,1057,52
3ad79a6a21e0039fb451044b2b9e71f83f258311,org.apache.tika.parser.microsoft.ooxml,1,2,1056,-1
33171a5635184bfcf54afccd72b0dee0529f9f0a,org.apache.tika.parser.microsoft.ooxml,28,0,1084,28
c9d44dbdd1cf61f17ed07d0df36af95d9ca51d0a,org.apache.tika.parser.microsoft.ooxml,45,33,1096,12
b2b3685e8a3b9cddde06fe77bf7c3d1ed9ba4899,org.apache.tika.parser.microsoft.ooxml,8,0,1104,8
ed8497d10df01374ddc63ec6cc988c191a881b95,org.apache.tika.parser.microsoft.ooxml,7,2,1109,5
85a8a767146619a071f89c72aa4ab25baec6ee98,org.apache.tika.parser.microsoft.ooxml,34,2,1141,32
11970650568d41bd2318d3513c011240b7be3ecf,org.apache.tika.parser.microsoft.ooxml,18,21,1138,-3
b471e61c790dcd9f6ad6be77f46f2e07afc56947,org.apache.tika.parser.microsoft.ooxml,70,30,1178,40
b8223f9c1353db748a7e1869bd9fe77e5e0ad5d7,org.apache.tika.parser.microsoft.ooxml,1,0,1179,1
11bbc01edef720419f3b68e0487ef057cf13a387,org.apache.tika.parser.microsoft.ooxml,12,1,1190,11
5fcd987552677d28721931f4fddc0192db7f2b9c,org.apache.tika.parser.microsoft.ooxml,12,2,1200,10
40de6ed08e7fd0abb09053b429b9c7248cb53b8b,org.apache.tika.parser.microsoft.ooxml,2,0,1202,2
f9e1dddacfeda4498dfe7c09feee33a403ef3e7c,org.apache.tika.parser.microsoft.ooxml,5,1,1206,4
f878d8e5e65d93b10c92272e45e87d6a37e655f4,org.apache.tika.parser.microsoft.ooxml,289,289,1206,0
c1f7fd7e5de2c31eddf9b0df086d214ea9adf08c,org.apache.tika.parser.microsoft.ooxml,916,916,1206,0
9a2bef7e4d893d7bbde4a267bf3eca6da40ecab2,org.apache.tika.parser.microsoft.ooxml,1,1,1206,0
ca80cad420b6562c57058384a166390d289da9a6,org.apache.tika.parser.microsoft.ooxml,443,8,1641,435
2d822bce6cda2e38b5ebb12af74073df41e8e7e9,org.apache.tika.parser.microsoft.ooxml,2,62,1581,-60
cdd1aa5684e484841aaf0c49138e712f6bfcc8aa,org.apache.tika.parser.microsoft.ooxml,115,27,1669,88
3620143ac8c694f7bdea31f2e67c26d86a3f18ab,org.apache.tika.parser.microsoft.ooxml,24,21,1672,3
d0cd679a119eb1ebcea1bce1f0d0ce9ea39e72bd,org.apache.tika.parser.microsoft.ooxml,263,120,1815,143
2d396c805097bb5f2618038cfbe43e3302e77737,org.apache.tika.parser.microsoft.ooxml,6,4,1817,2
232644056696011a772f93aea1907ee462f27767,org.apache.tika.parser.microsoft.ooxml,28,0,1845,28
7e2de56d031c8df26082a67e5835799884d13c03,org.apache.tika.parser.microsoft.ooxml,7,15,1837,-8
453ae26882aa74faf4121b0713fd8d815e8804b7,org.apache.tika.parser.microsoft.ooxml,5,2,1840,3
21c35f73d28d88d0ec8db91a7a458fe70da85f84,org.apache.tika.parser.microsoft.ooxml,16,5,1851,11
3dd12110dad0e5a71555d4e4a0e5a6cd609b0fb7,org.apache.tika.parser.microsoft.ooxml,1,1,1851,0
e54acb41e2af27ed032a18b7d7197f6eae075d0d,org.apache.tika.parser.microsoft.ooxml,37,22,1866,15
7c8ac0b2023b771d252822f1ec133fe41d15a624,org.apache.tika.parser.microsoft.ooxml,0,5,1861,-5
0fa372711329b8765545b9f28f1112d9e955352e,org.apache.tika.parser.microsoft.ooxml,2,3,1860,-1
9fbce438928982a43fa2ffac51d8550d39a47bef,org.apache.tika.parser.microsoft.ooxml,269,104,2025,165
b206755d21482a519180e5a70f760e494ee73252,org.apache.tika.parser.microsoft.ooxml,4,3,2026,1
2ebf67889c2b2a0bf3cdbd37d6d80603d7bacfd6,org.apache.tika.parser.microsoft.ooxml,52,23,2055,29
cf732522e9845cb6a016541e484538518f752c12,org.apache.tika.parser.microsoft.ooxml,6,2,2059,4
3b61cea5aba160f9289db7d913aec2c00c3b7a6e,org.apache.tika.parser.microsoft.ooxml,2,11,2050,-9
7dc399b99823bbbd77ab6e6ab0b9cc1870210c0c,org.apache.tika.parser.microsoft.ooxml,24,2,2072,22
553d7690f8e784236638f65932c208e51e11d0c1,org.apache.tika.parser.microsoft.ooxml,1,1,2072,0
d029485082dc999ef7845cb50cc60c8a3004329a,org.apache.tika.parser.microsoft.ooxml,1,5,2068,-4
d75b3660192a55148993bc6716165868919622bb,org.apache.tika.parser.microsoft.ooxml,7,1,2074,6
907880f1c3f86e55fd83eae3209a5b238e580a06,org.apache.tika.parser.microsoft.ooxml,2,0,2076,2
5716665ac46861acb3b14fd56ed8b91d6ddc91f8,org.apache.tika.parser.microsoft.ooxml,1,1,2076,0
1fcb10afd65a0a007beb631a3ac5f1f6b8027d35,org.apache.tika.parser.microsoft.ooxml,17,4,2089,13
49a39911358635489e3b3fdfea10ea3f0759dd30,org.apache.tika.parser.microsoft.ooxml,3,0,2092,3
e7b51f0ea9a76e351fef07c806dce00ff47a2888,org.apache.tika.parser.microsoft.ooxml,15,4,2103,11
5aa2fc4efc3ba654238fc532f6e654c20bac1154,org.apache.tika.parser.microsoft.ooxml,0,1,2102,-1
4316d8d9100efc3a47be53680a75515a3f040fca,org.apache.tika.parser.microsoft.ooxml,37,19,2120,18
600e69ddfd9558c48d41f66982cd0359d438f4be,org.apache.tika.parser.microsoft.ooxml,2,2,2120,0
9d73a101d5bd8f9ba3ba12f842862e2a72f14019,org.apache.tika.parser.microsoft.ooxml,103,57,2166,46
e25a4543bcd1414d1288bb544b65afc8727a6f87,org.apache.tika.parser.microsoft.ooxml,12,11,2167,1
b4bfb99c580cf647b4c7691ecd91cb80f44d55f5,org.apache.tika.parser.microsoft.ooxml,17,4,2180,13
07f6f6341cc11520eb1de18a4b9b712ac514f28d,org.apache.tika.parser.microsoft.ooxml,139,3,2316,136
04d1fb7cc895e054941280e991ef129cde11ab8b,org.apache.tika.parser.microsoft.ooxml,15,14,2317,1
9cb9439d367c9f35cd34723c73b7ed2f36edeb50,org.apache.tika.parser.microsoft.ooxml,39,8,2348,31
e924f82d636a4e8da097822405493a565b039fa2,org.apache.tika.parser.microsoft.ooxml,2,8,2342,-6
5c22595f655362f983e73aca4fb79149f37a17ec,org.apache.tika.parser.microsoft.ooxml,2,0,2344,2
24ef1035df8f53a1750884e8cff91d277528e6a9,org.apache.tika.parser.microsoft.ooxml,124,68,2400,56
ad30687ead0422e4e71af4d7632f920af5b678fa,org.apache.tika.parser.microsoft.ooxml,0,2,2398,-2
ea21418703d689ad0fa926ca49a941076b5ac43a,org.apache.tika.parser.microsoft.ooxml,13,0,2411,13
6187e037e0c72294440ef38e9fc3b76a002180ca,org.apache.tika.parser.microsoft.ooxml,0,3,2408,-3
acbefdf903b19385d7557cf6c41380afe81b5eed,org.apache.tika.parser.microsoft.ooxml,11,0,2419,11
1de7bfe9080607ab8c0b052a84d7939539c854c7,org.apache.tika.parser.microsoft.ooxml,17,0,2436,17
ec9d7d201f0fb580a32b599a6340a220063ca82c,org.apache.tika.parser.microsoft.ooxml,12,10,2438,2
a682c4c961d6940adedc55b57f40235bcc8f59d6,org.apache.tika.parser.microsoft.ooxml,3,0,2441,3
98365924bf5b7ec36b8317809f82855e0f9e17b9,org.apache.tika.parser.microsoft.ooxml,39,1,2479,38
25f7a4d5dac3b7d4bebaed41ef43bf37d1e86814,org.apache.tika.parser.microsoft.ooxml,2,12,2469,-10
2e976ca42e1beae14a706e9461f59e078f4d3704,org.apache.tika.parser.microsoft.ooxml,4,0,2473,4
6673d51674946be52905ad5b448ba2051092fe19,org.apache.tika.parser.microsoft.ooxml,2,7,2468,-5
a39d5824b631d13571abc60ad7e15d7afbf449dc,org.apache.tika.parser.microsoft.ooxml,16,0,2484,16
7e2393fabca843e0c596eae2a29aebea3a937842,org.apache.tika.parser.microsoft.ooxml,27,37,2474,-10
60711a9496a6387c125f8138b3b34a799a3f4c94,org.apache.tika.parser.microsoft.ooxml,1,1,2474,0
03e6113c9ea555bf93b9ce064a2c0d1cd8073cc5,org.apache.tika.parser.microsoft.ooxml,1,18,2457,-17
9e22f46f2403b89dbc8454cefb8b83881f437419,org.apache.tika.parser.microsoft.ooxml,19,1,2475,18
83a8a97e02d1ac479bbea6770732e4ea9d8fcf7f,org.apache.tika.parser.microsoft.ooxml,3,0,2478,3
e303705a4beab60fe4dad27f29621939fe2f0d0a,org.apache.tika.parser.microsoft.ooxml,3,3,2478,0
4b51beae8e08e82458792a63dd867319cb40e1e4,org.apache.tika.parser.microsoft.ooxml,89,0,2567,89
0c52b66e9dd568cd9af1529cd1b0fa0819c53e9d,org.apache.tika.parser.microsoft.ooxml,141,12,2696,129
36986261cdfade8c8c33a417f20638467e83e660,org.apache.tika.parser.microsoft.ooxml,49,47,2698,2
36bbcfca96f67edb19bcd63d6c3f96dbf47e7041,org.apache.tika.parser.microsoft.ooxml,52,48,2702,4
8f05b4e99721921279f2656663c58b403eff2329,org.apache.tika.parser.microsoft.ooxml,3,2,2703,1
b754b456c3871c453466ff06f60eedf433547eaa,org.apache.tika.parser.microsoft.ooxml,8,2,2709,6
e48876756c9b1042e27529e71756df079af70e12,org.apache.tika.parser.microsoft.ooxml,7,1,2715,6
232cc5ddc7a1adb357959102accd52a3ee11d755,org.apache.tika.parser.microsoft.ooxml,4,2,2717,2
00a14bb29de9d26224720194d596604f90570480,org.apache.tika.parser.microsoft.ooxml,46,7,2756,39
89dc4d725fc4a1dd3406c462bb0e2b8575c5d34f,org.apache.tika.parser.microsoft.ooxml,41,24,2773,17
923ef5d6b2101a7500955b9709967c7277ff5674,org.apache.tika.parser.microsoft.ooxml,35,31,2777,4
c5084471e00852abbeb9e4986f2a391f7a827d44,org.apache.tika.parser.microsoft.ooxml,25,17,2785,8
328b935c08b61bf785ec99952c687f04f7cf989f,org.apache.tika.parser.microsoft.ooxml,35,11,2809,24
07a1590839bff6f16ac19b031a26e128141e19a2,org.apache.tika.parser.microsoft.ooxml,35,27,2817,8
efdb4679cb28841da7ba9d8e755596602b630893,org.apache.tika.parser.microsoft.ooxml,2,0,2819,2
c36e5a0461b66a7941156dd9ee502c73aa0ee28c,org.apache.tika.parser.microsoft.ooxml,2,0,2821,2
f58064ea00381a9c9fc28b0378dbf9f794dd7be3,org.apache.tika.parser.microsoft.ooxml,4,0,2825,4
9e21496385fa21e15fbe1f9d2d7160678151fa7c,org.apache.tika.parser.microsoft.ooxml,82,7,2900,75
22b12358690f50988086507211fa464beb2553b4,org.apache.tika.parser.microsoft.ooxml,50,5,2945,45
a846f7d215ab46a0ab027ad84e809484da81da80,org.apache.tika.parser.microsoft.ooxml,20,1,2964,19
433f21c4805e7bb930964f87d15c30f62e0eb5d5,org.apache.tika.parser.microsoft.ooxml,14,6,2972,8
4e09c6360355b73801b95c97e139619acbe012bd,org.apache.tika.parser.microsoft.ooxml,15,0,2987,15
963100eb1806048809b1fb2cb5076afdd640cdfa,org.apache.tika.parser.microsoft.ooxml,0,30,2957,-30
9ec715349810ab8e2d149028679ba6baebeae14b,org.apache.tika.parser.microsoft.ooxml,61,13,3005,48
ab9f799ae4a3eec42e00a109ca3171cbdf7b6cd0,org.apache.tika.parser.microsoft.ooxml,23,1,3027,22
c4581fb85824ad27725e17aeb49bfbe12ebea40a,org.apache.tika.parser.microsoft.ooxml,8,0,3035,8
281bcf591911f156c5592087b897ce293740239a,org.apache.tika.parser.microsoft.ooxml,24,1,3058,23
5dd29c4fd97c9a9de8d716e52e4998db1e92176d,org.apache.tika.parser.microsoft.ooxml,76,30,3104,46
970bafe849a6aa2e4e5ed1140e033fdb9c8abe32,org.apache.tika.parser.microsoft.ooxml,146,79,3171,67
2cf36cca67ae5a766e1a46d4a7de54df9cda9740,org.apache.tika.parser.microsoft.ooxml,30,1,3200,29
e9c0166da98b55b66b217e4fe6afd13904c620d6,org.apache.tika.parser.microsoft.ooxml,24,0,3224,24
ed60a56b5109a4c1b92a263a5f431d688d02dc80,org.apache.tika.parser.microsoft.ooxml,5,2,3227,3
145bf2f8d7104f64a446b5fbd1015a71a9f1721d,org.apache.tika.parser.microsoft.ooxml,10,9,3228,1
2ac245fc84207c6d61fd6ca9195d24eb91747fe9,org.apache.tika.parser.microsoft.ooxml,11,0,3239,11
9227e9f3d5090be28e28639ab92732c5be0507cf,org.apache.tika.parser.microsoft.ooxml,9,25,3223,-16
2a36fcd63ddd3234b7f34e6814972bb62aeb4bc9,org.apache.tika.parser.microsoft.ooxml,48,3,3268,45
2ae3e9020d9a89eaaae164e602579b6e52da2349,org.apache.tika.parser.microsoft.ooxml,148,57,3359,91
398f50f51fb363b9aac60ec50f54d977089ef957,org.apache.tika.parser.microsoft.ooxml,1,0,3360,1
628842dc89c938f5780b3926cfcdcf12fff42ee6,org.apache.tika.parser.microsoft.ooxml,0,2,3358,-2
41530451deca7dff7478eec8351df537b6942875,org.apache.tika.parser.microsoft.ooxml,7,0,3365,7
2cf27a74c57814692655f7f6c44754a8571a44c9,org.apache.tika.parser.microsoft.ooxml,22,22,3365,0
85137c5c3d3bd867769e3028b50e8907e8054799,org.apache.tika.parser.microsoft.ooxml,0,5,3360,-5
2936d550002fe564beb99e56eb6b4c5a7d33d36a,org.apache.tika.parser.microsoft.ooxml,4,5,3359,-1
a13fdace85d18eccc4ec9ee918e86541204374b1,org.apache.tika.parser.microsoft.ooxml,12,4,3367,8
e07922df5cc3ddd32194782799d0e7fdb9a402a8,org.apache.tika.parser.microsoft.ooxml,32,33,3366,-1
bf9d5c4c2a827455ab750db19afcaf4164cbdbd4,org.apache.tika.parser.microsoft.ooxml,3,3,3366,0
262432122d5acf191ae1df8801a655feebd46a97,org.apache.tika.parser.microsoft.ooxml,6,10,3362,-4
080b03607aba6275dbede13fc15e9c1bd525f410,org.apache.tika.parser.microsoft.ooxml,3,1,3364,2
6cc0e11b91ee5ebe97ea91fc50a76074f45829c2,org.apache.tika.parser.microsoft.ooxml,2,2,3364,0
0365ed2e430f3513931c01994e75fa55d1fb1b01,org.apache.tika.parser.microsoft.ooxml,5,17,3352,-12
a6b6ad4e496f683690434a98645139567193d53f,org.apache.tika.parser.microsoft.ooxml,100,41,3411,59
892f3a8b1e44efdf86ec9aed0887de7afcbf01ea,org.apache.tika.parser.microsoft.ooxml,4,3,3412,1
257a53b8a83caa5de9067b9c3b3b5e2b356f674d,org.apache.tika.parser.microsoft.ooxml,34,0,3446,34
3e9db56e11340c06c39e71df4d320033eda5810c,org.apache.tika.parser.microsoft.ooxml,2,1,3447,1
a7b50cac3293308f5a79d77664d0ec48d466163c,org.apache.tika.parser.microsoft.ooxml,281,24,3704,257
5239ee7922c52a6a5281f3671ee9b31f7707f5bb,org.apache.tika.parser.microsoft.ooxml,1360,1359,3705,1
826467e20587fcabf3d292c192d077b4fdee413f,org.apache.tika.parser.microsoft.ooxml,12,1,3716,11
9688c77128e5c3d53c1eeb4e72db62ff10dfafda,org.apache.tika.parser.microsoft.ooxml,23,0,3739,23
194a301ce3786a40683213aa3d0e4ae7155d747a,org.apache.tika.parser.microsoft.ooxml,11,17,3733,-6
19eb4448304abff6322d830ccee7ed868d443d71,org.apache.tika.parser.microsoft.ooxml,1,1,3733,0
d5981c7079c23c58dbb91aebce30de5498f51b8a,org.apache.tika.parser.microsoft.ooxml,3,3,3733,0
8938fdfa93f8c0647e547e8a04a187fbb5a32603,org.apache.tika.parser.microsoft.ooxml,38,118,3653,-80
285a462b0404aeee36a856f445cb08fdce475035,org.apache.tika.parser.microsoft.ooxml,10,7,3656,3
8d8823ad9e8281cf79c492d714ae2a815644f763,org.apache.tika.parser.microsoft.ooxml,24,2,3678,22
2a560ebd11beff94f105b7adab4a367f9388527a,org.apache.tika.parser.microsoft.ooxml,98,49,3727,49
5a7027a1d2a82895b49d4131ef20f3e59e417712,org.apache.tika.parser.microsoft.ooxml,1,4,3724,-3
25cee54499126de2b90f6bd5bde8de470b422349,org.apache.tika.parser.microsoft.ooxml,4,4,3724,0
6ac99bf413f476281d3eddef1f86dd9c11fe12d1,org.apache.tika.parser.microsoft.ooxml,0,1,3723,-1
f054bcd1a0a57a730ebc53e7a2cfd4215a7526fb,org.apache.tika.parser.microsoft.ooxml,4,5,3722,-1
0c030081bba17e607f8c79a0b95f72935be93efd,org.apache.tika.parser.microsoft.ooxml,4,0,3726,4
7ebe007ec03088449f67619ef1e6cb564178b14b,org.apache.tika.parser.microsoft.ooxml,4,0,3730,4
1caa4fb6ac971dbcdcbb22b9c2f77d7051e922b9,org.apache.tika.parser.microsoft.ooxml,3,2,3731,1
e9206475e683c35b09810a857ddd7bdbfa8f60fb,org.apache.tika.parser.microsoft.ooxml,22,1,3752,21
71f8423b0403955265a0726ff3173cc5708518c4,org.apache.tika.parser.microsoft.ooxml,17,14,3755,3
172c58443550d256a94994aba24c6600a2397256,org.apache.tika.parser.microsoft.ooxml,5,6,3754,-1
da1fe243ace68cc2b5c4bde022113233ad95ea15,org.apache.tika.parser.microsoft.ooxml,44,21,3777,23
80b27e6d843d221de87591d34632e546c0d23b1a,org.apache.tika.parser.microsoft.ooxml,5,6,3776,-1
c9d508dc184244bdc08657e7da2f33b9a1fd6bd2,org.apache.tika.parser.microsoft.ooxml,1,0,3777,1
2caf3da7cfeca675530fa86c6f76c451a433e732,org.apache.tika.parser.microsoft.ooxml,1,0,3778,1
ab7c3253b8450c2d483edab60e4365fef0c4ae38,org.apache.tika.parser.microsoft.ooxml,1,4,3775,-3
69852e4cb55d34e6513e0b66af7d75cb1b1408ba,org.apache.tika.parser.microsoft.ooxml,141,32,3884,109
bb78082b0028b57a5bf1ae30858dda6aebeacf63,org.apache.tika.parser.microsoft.ooxml,0,1,3883,-1
e780d56652d48dd0f50b4e62a58153e95f055022,org.apache.tika.parser.microsoft.ooxml,184,55,4012,129
b6d55ae345db933d69cc9a7d290e3f8ca567b5a9,org.apache.tika.parser.microsoft.ooxml,2,0,4014,2
7cc610e1b3f164fe9de00b1a35e60fd00a69bb46,org.apache.tika.parser.microsoft.ooxml,20,2,4032,18
52f04bea6075003540a9d8b57768f814f908c442,org.apache.tika.parser.microsoft.ooxml,3,3,4032,0
a57d8364c378778a14b205e0528e43a1f9fac417,org.apache.tika.parser.microsoft.ooxml,18,2,4048,16
23a11eff3018977f031cce663bb412678f08ba89,org.apache.tika.parser.microsoft.ooxml,4,4,4048,0
fe559b80bcad1f107904ca7a89724a26ea2921a1,org.apache.tika.parser.microsoft.ooxml,179,35,4192,144
a383567c2c947603c4c7aa12d3578d771bb58413,org.apache.tika.parser.microsoft.ooxml,24,6,4210,18
80efc84b675c8defa5e86b01b85e1dabc84d32f5,org.apache.tika.parser.microsoft.ooxml,45,18,4237,27
27b9cf566da9772961b2fac3c2aa6cc1648ab2a5,org.apache.tika.parser.microsoft.ooxml,20,2,4255,18
d50a69361bd0196fb2595313cb47222f61701ba4,org.apache.tika.parser.microsoft.ooxml,89,26,4318,63
2ae7206d9c99fb553314cff21bb155d4e6f06d12,org.apache.tika.parser.microsoft.ooxml,77,16,4379,61
8a45f67a2e3641b08fcfb5e2283e4a43ff86f3cd,org.apache.tika.parser.microsoft.ooxml,24,21,4382,3
b3f1497caaafa1b53295d87592329f8d7cbca38b,org.apache.tika.parser.microsoft.ooxml,3,1,4384,2
01163e23cc9d1701e4a23f6cb13771a31aa99f08,org.apache.tika.parser.microsoft.ooxml,2,1,4385,1
47ba703d6e682147fa3e6abb9a9cc756c7fc2760,org.apache.tika.parser.microsoft.ooxml,2,10,4377,-8
81fad8c97e60a3de7d926dc4ce10cbd235549583,org.apache.tika.parser.microsoft.ooxml,1258,0,5635,1258
d19e4725ff0549597f9156bb0c1e7759f6ce08d9,org.apache.tika.parser.microsoft.ooxml,1487,284,6838,1203
fe20ecd83ea43e5ec6ad0e9fded9d803cb011251,org.apache.tika.parser.microsoft.ooxml,8,8,6838,0
894301307da5167c95585688f9448d3050f53aaa,org.apache.tika.parser.microsoft.ooxml,710,187,7361,523
f93d4e1fffdb4a441f7fa750a43691adfa70c392,org.apache.tika.parser.microsoft.ooxml,35,22,7374,13
1aca10a26dada02a045a1bc9eb7c3cfc1b36a83e,org.apache.tika.parser.microsoft.ooxml,70,33,7411,37
806eaf8b1802a3a3071a5ae0bdc35c20d6739280,org.apache.tika.parser.microsoft.ooxml,193,12,7592,181
4469ca2c4ea725e9f5d94c116aaf248deea2a6eb,org.apache.tika.parser.microsoft.ooxml,142,37,7697,105
615bf75fc11e8fc299be550b8cd4bb24f45a264a,org.apache.tika.parser.microsoft.ooxml,34,4,7727,30
3ee9fd5bf3df913dc8d3cf8cf76da433bb7f9e17,org.apache.tika.parser.microsoft.ooxml,330,97,7960,233
192e3caa77b7c23a99d0d3abb2b8f41f335481e0,org.apache.tika.parser.microsoft.ooxml,0,3,7957,-3
faf6c2b24814ded27f05388f8a417c2df5bf5c7a,org.apache.tika.parser.microsoft.ooxml,55,10,8002,45
0f78a314f52b64d84072758ea66fc0d797271f2f,org.apache.tika.parser.microsoft.ooxml,77,20,8059,57
653b980f51feff361381f440bef087e20c69784f,org.apache.tika.parser.microsoft.ooxml,190,174,8075,16
90cdf1f6a844e0d0541167bc0364bb3963f93b2d,org.apache.tika.parser.microsoft.ooxml,1954,159,9870,1795
ca37313a716d4eaa3a15a4ba770f89ee23832e99,org.apache.tika.parser.microsoft.ooxml,130,55,9945,75
376318fc1b34014ec31d5fbfdfa962183ea8c717,org.apache.tika.parser.microsoft.ooxml,126,729,9342,-603
66f6310eec8e8aade078f0ca32a07399008ef1b1,org.apache.tika.parser.microsoft.ooxml,2,2,9342,0
8eb7d352f6b7a488bfdca172a0707cb514157a34,org.apache.tika.parser.microsoft.ooxml,83,50,9375,33
526fc08f2a0a4c44ea191a10748ca9ef0e834cb3,org.apache.tika.parser.microsoft.ooxml,17,3,9389,14
280ab87e859ef3ca511994b9b7c2a21c8e0d7511,org.apache.tika.parser.microsoft.ooxml,123,58,9454,65
3c0cd647571d23665056de9adcaf5d58dc087fb9,org.apache.tika.parser.microsoft.ooxml,7,3,9458,4
27e026eff589f5829ddb4374de0d85daf37a9d2a,org.apache.tika.parser.microsoft.ooxml,1,6,9453,-5
256a2814f2ee3e7d5f5d9b24447806d6204e4ae0,org.apache.tika.parser.microsoft.ooxml,19,3,9469,16
315a0d6be3714024dd5259444f739a026f0de574,org.apache.tika.parser.microsoft.ooxml,348,17,9800,331
fbd2a4ea272ad90812d50b6c9fec3cd50b3d632b,org.apache.tika.parser.microsoft.ooxml,2,283,9519,-281
a00ced9fe9dbfeb8b6241a9dc4bd74756ec3a3b0,org.apache.tika.parser.microsoft.ooxml,2,1,9520,1
19c0e916982174da20ee98196db840c7465471eb,org.apache.tika.parser.microsoft.ooxml,221,14,9727,207
5877c4c8702a10a76b6c3ee59fbae7daf3c9b062,org.apache.tika.parser.microsoft.ooxml,5,5,9727,0
3aab15f8f277614e3c5783c4862e25d63b737425,org.apache.tika.parser.microsoft.ooxml,18,1,9744,17
dbdead5c1ab375cc615a1db3254be0aac47e209b,org.apache.tika.parser.microsoft.ooxml,239,15,9968,224
67612b8f805ad5d1085db14922d3b3b6ddce19bf,org.apache.tika.parser.microsoft.ooxml,338,29,10277,309
aa4954fb44f707779693faea785acc219739ccd5,org.apache.tika.parser.microsoft.ooxml,20,7,10290,13
0876aa909ffb77dfbd384ebe2f5de0a873ab489a,org.apache.tika.parser.microsoft.ooxml,4,2,10292,2
562e4faf95bc85b3ab2290055860d3e075a66451,org.apache.tika.parser.microsoft.ooxml,67,2,10357,65
d64a32c63f376b9e003a4512adfec05414d4dfe6,org.apache.tika.parser.microsoft.ooxml,47,2,10402,45
70d2455c4ff7c54afe6762d5b50653b8de06f2b2,org.apache.tika.parser.microsoft.ooxml,428,39,10791,389
e56e2b2915e8cebcf97c69cdcb3ecff861434f61,org.apache.tika.parser.microsoft.ooxml,6412,216,16987,6196
46334b8821d3d9df86491fdc46f669c0c7f39020,org.apache.tika.parser.microsoft.ooxml,47,12,17022,35
6b174ecbb70d1236bdb9886f86bf94f51d3dd881,org.apache.tika.parser.microsoft.ooxml,693,45,17670,648
ed57e6edb225948ca10e2fcb25f8e0fce45f8fc0,org.apache.tika.parser.microsoft.ooxml,15,8,17677,7
7842600560e02a4fd213d175301b4397bbe030a3,org.apache.tika.parser.microsoft.ooxml,218,69,17826,149
d2820ce62545c847a2d3e79b7b4b8a3f2022a619,org.apache.tika.parser.microsoft.ooxml,128,5,17949,123
5cbaed87235c2cee49c9d4fa15d84158d000e986,org.apache.tika.parser.microsoft.ooxml,86,19,18016,67
134cb3812aba88152f665c1d14ff65092f21d051,org.apache.tika.parser.microsoft.ooxml,441,95,18362,346
ebb4bc6d7bf82fe618b7a4b5f4e9b4278b96c0d2,org.apache.tika.parser.microsoft.ooxml,426,87,18701,339
b9825c608b0553ba780e1f3a92d6f67bb57aadae,org.apache.tika.parser.microsoft.ooxml,0,11,18690,-11
7fd5bd743ab5a242e9c3225f5af6b48235a18455,org.apache.tika.parser.microsoft.ooxml,47,0,18737,47
b618984cc78df5696886404c6579d2bad71e1bb8,org.apache.tika.parser.microsoft.ooxml,488,106,19119,382
8eef0562f82088db3bb66d17d8eb28188468112e,org.apache.tika.parser.microsoft.ooxml,47,11,19155,36
9f0144c248c210c03b7a3f3afa7885211dde3b52,org.apache.tika.parser.microsoft.ooxml,15,0,19170,15
4e03f90cf0a20375819f33371ec094386a744f36,org.apache.tika.parser.microsoft.ooxml,71,43,19198,28
b422edafa74dc2d9efc4c8d01d59fd468e915840,org.apache.tika.parser.microsoft.ooxml,71,43,19226,28
3621ee4abde21f66ebab200ba2788e160b8df65d,org.apache.tika.parser.microsoft.ooxml,133,54,19305,79
74574e38cb2f53395c185742928052d17b181b5a,org.apache.tika.parser.microsoft.ooxml,31,1,19335,30
5638ebc0db0b88341ba663d5ba12eebbe2925240,org.apache.tika.parser.microsoft.ooxml,75,11,19399,64
7dd38d5500c539328e2b0a083e1998a28e680539,org.apache.tika.parser.microsoft.ooxml,75,11,19463,64
f16bd0e2dc8b86fc3cc58b9a80dc7544d549651d,org.apache.tika.parser.microsoft.ooxml,23,21,19465,2
b5f5403fb150f2a290fe1cfa10a6fe572b1dd50a,org.apache.tika.parser.microsoft.ooxml,23,21,19467,2
93cbed6df993ef01e59c55b86449b664e9052cae,org.apache.tika.parser.microsoft.ooxml,49,3,19513,46
d4fd659ac5c3070104a85df4a535afe570b08a0e,org.apache.tika.parser.microsoft.ooxml,27,1,19539,26
6fa83ffd835f5af7dd813213776933a5080c56b6,org.apache.tika.parser.microsoft.ooxml,22,15,19546,7
ef3fc7bd4de8856038bf31eb0a3dddb343f52d28,org.apache.tika.parser.microsoft.ooxml,147,11,19682,136
a047fa945c033666723cd0f18c536c1d56cac436,org.apache.tika.parser.microsoft.ooxml,32,26,19688,6
f57e0e78c3882c5003cf15b18375a334944d24dd,org.apache.tika.parser.microsoft.ooxml,11,0,19699,11
533354d1a0e7e0b3b4ced7b7958f6e34041bf502,org.apache.tika.parser.microsoft.ooxml,811,5,20505,806
10a8eec119c7a77be76000b30aaffb96a552cc44,org.apache.tika.parser.microsoft.ooxml,89,139,20455,-50
e6e3b8817053e981f3843f1d3b7055b4ae30ed73,org.apache.tika.parser.microsoft.ooxml,89,139,20405,-50
4c510d6a9910044825c6ee8df87c419a3370ab4e,org.apache.tika.parser.microsoft.ooxml,53,0,20458,53
16a8ff95290027682762932b6b29463790fe5b6d,org.apache.tika.parser.microsoft.ooxml,29,5,20482,24
f8b1d9a87c0954c7efb32606d2cce380fddc82a1,org.apache.tika.parser.microsoft.ooxml,29,5,20506,24
50f8591c6c87b756d6d8881c95f9794c51ffa240,org.apache.tika.parser.microsoft.ooxml,2,2,20506,0
1a0d1d3056f0f45a3cb912939784f20767741e7e,org.apache.tika.parser.microsoft.ooxml,16,3,20519,13
b1b035e6bbcff0db24e133b682ac79916f92f599,org.apache.tika.parser.microsoft.ooxml,31,6,20544,25
64bb30844e0caafff1c9ebac7c8b0c5b512ea81e,org.apache.tika.parser.microsoft.ooxml,68,15,20597,53
8110645cc4b181fefd9663b1592213e79a298b0e,org.apache.tika.parser.microsoft.ooxml,2,0,20599,2
e24e6afb1c2a37be266839767115ad6adc5f8dcf,org.apache.tika.parser.microsoft.ooxml,38,77,20560,-39
bc24ccb302d1454a226dbfd38337b8f8050d7e4a,org.apache.tika.parser.microsoft.ooxml,6,0,20566,6
e7b481dd763ff4f586a94b981281923e4604010a,org.apache.tika.parser.microsoft.ooxml,6,0,20572,6
0486852c46f42130c2f1c26cdd35f38005457a83,org.apache.tika.parser.microsoft.ooxml,37,25,20584,12
5cb8d9a9e091ee61c8dc0f334d23c7677f5f519b,org.apache.tika.parser.microsoft.ooxml,2,146,20440,-144
933ad02751de2e622ed8b98ca7a2ccaed9e8a3a5,org.apache.tika.parser.microsoft.ooxml,4,2,20442,2
01c53eaa6d709972b03735574aa58dc0abcdc51c,org.apache.tika.parser.microsoft.ooxml,94,92,20444,2
0b2575b272c727f7c20cc58149dfec9a258ac799,org.apache.tika.parser.microsoft.ooxml,144,55,20533,89
64302aa88bd8de81771712ccafa778a34cefd7c2,org.apache.tika.parser.microsoft.ooxml,2,2,20533,0
93a2c2740edd803cba0273dec92e69c1f2a60dbe,org.apache.tika.parser.microsoft.ooxml,230,2,20761,228
75c8b9f6719555d72ee838880c25280304a9e2e1,org.apache.tika.parser.microsoft.ooxml,3,3,20761,0
06cf66cef14863fee0111dddefaebaa051a40c72,org.apache.tika.parser.microsoft.ooxml,20,2,20779,18
74e1cdb2d1ab0f50e85a116de2f0d9eeb42c6dac,org.apache.tika.parser.microsoft.ooxml,0,1,20778,-1
4131c6e30f2e0eb1feb85e0f7576531d4e830468,org.apache.tika.parser.microsoft.ooxml,2,67,20713,-65
64877c5a6187ecd13e098e99edc97a1f6dc09112,org.apache.tika.parser.microsoft.ooxml,36,7,20742,29
cf5b8123769cb094163331a1395487c1f874c296,org.apache.tika.parser.microsoft.ooxml,36,7,20771,29
919768a649ebb4585ce45cf0f0a37ee0bb371355,org.apache.tika.parser.microsoft.ooxml,17,147,20641,-130
d7006b8cebdb6e97ad14e9536021cc70e01b3923,org.apache.tika.parser.microsoft.ooxml,5,5,20641,0
e1ed5ccd813de86fedb12d77da41d58970b9f52c,org.apache.tika.parser.microsoft.ooxml,21,151,20511,-130
f9cccabcb2d2580739039fbef60f06da97668b13,org.apache.tika.parser.microsoft.ooxml,3,3,20511,0
6745e8db32390ea94ca14f11ef02aa00f1ffc37e,org.apache.tika.parser.microsoft.ooxml,3,3,20511,0
0d9dacdc6ca153572a7570f7934ec82f1c2ea92e,org.apache.tika.parser.microsoft.ooxml,6,0,20517,6
22ff7564f2641ba195f192d7c59e9df4a3a10747,org.apache.tika.parser.microsoft.ooxml,40,5,20552,35
ebbd895749337f5bfaa4a653d245ba9356f3207c,org.apache.tika.parser.microsoft.ooxml,25,0,20577,25
182566114e368ed068ffd9707d77a37ff545efab,org.apache.tika.parser.microsoft.ooxml,1,1,20577,0
313ef8b53ad3bba3f0910bcfb25db683ba6ba209,org.apache.tika.parser.microsoft.ooxml,178,337,20418,-159
547bc73ca009fade75a5fd6062160cd517fb035e,org.apache.tika.parser.microsoft.ooxml,19,2,20435,17
6378e9617b66c4618d78651112c9b201ee5779f9,org.apache.tika.parser.microsoft.ooxml,1,1,20435,0
0cdbbcb45e2fde2963bcf65d485cd7c414779ae9,org.apache.tika.parser.microsoft.ooxml,47,0,20482,47
3af197241323c5b94018ea20086c2cd21ea796d8,org.apache.tika.parser.microsoft.ooxml,0,1,20481,-1
b329820804bb74cc290337041eee595395e77435,org.apache.tika.parser.microsoft.ooxml,7,4,20484,3
4a4a53e15ed5bae19780d70bda30c58f3878aecd,org.apache.tika.parser.microsoft.ooxml,34,1,20517,33
f9104d17ad0b92b243501fdf0863b4ccdaa5e791,org.apache.tika.parser.microsoft.ooxml,5593,5559,20551,34
b09b256c9c496b8788482a92066e79671c4a3531,org.apache.tika.parser.microsoft.ooxml,1,1,20551,0
d4a39b4873d939553e0742487b8c84f072497c1f,org.apache.tika.parser.microsoft.ooxml,32,0,20583,32
b5c3485e9f1c390565ccc0abc5e4609fdab9bd0a,org.apache.tika.parser.microsoft.ooxml,45,37,20591,8
53fef890942bdf69d455abbbecc17cd22d6621d6,org.apache.tika.parser.microsoft.ooxml,1,1,20591,0
44c0c83971ab5503db4e7258e258a0d3a360594a,org.apache.tika.parser.microsoft.ooxml,1,1,20591,0
faad4c316634880df054dc6178e18f172a132d4e,org.apache.tika.parser.microsoft.ooxml,12,18,20585,-6
37f0559c28dd485557f5d66e9c0fe6cb6123b225,org.apache.tika.parser.microsoft.ooxml,12,18,20579,-6
8dfee9ecff0ad4f01555abdae82d5e5e8e5c8690,org.apache.tika.parser.microsoft.ooxml,1,1,20579,0
49bd7d574143fde300151f70319d9cc25559e66d,org.apache.tika.parser.microsoft.ooxml,1,1,20579,0
7ed64a5bd8e564bbe8fce0948a71c1db249fa2fb,org.apache.tika.parser.microsoft.ooxml,1,1,20579,0
372ccd23e6399de9b5d9d93906645e1e4349ec99,org.apache.tika.parser.microsoft.ooxml,1,4,20576,-3
6401ca084ac9409bf6b6c94b2fa4ff293e427133,org.apache.tika.parser.microsoft.ooxml,7,7,20576,0
9ec102102119e6d398c53652e1a28c2c61600f5d,org.apache.tika.parser.microsoft.ooxml,17,19,20574,-2
8dbb5736fa92b323e270e2075b42dce458a3abd6,org.apache.tika.parser.microsoft.ooxml,0,4971,15603,-4971
a43784b19f6b0955478dded71521b0491d21c90b,org.apache.tika.parser.microsoft.ooxml,2785,0,18388,2785
12198666bf0cf6811613c9ae27c4a384e42875b1,org.apache.tika.parser.microsoft.ooxml,2186,0,20574,2186
6e3ee160366ebd6b336d7b9f12984486a3bb886e,org.apache.tika.parser.txt,114,0,114,114
780f13d348531efbda8da1fd11c51039e50f29a9,org.apache.tika.parser.txt,2,2,114,0
32fda63e7bfb1722a3e35d717f68e3242a259c47,org.apache.tika.parser.txt,1,1,114,0
4707526c2f2dc847c9031174f75f25ee94e54803,org.apache.tika.parser.txt,0,11,103,-11
6244bec006f1757753e29c543cf830104441f10d,org.apache.tika.parser.txt,21,29,95,-8
522f4f3ac2aa2f25be83242fcd5f778d8105615f,org.apache.tika.parser.txt,3,4,94,-1
cfe3527af83d582d12a43a6f42ff30bd2d15a379,org.apache.tika.parser.txt,11,60,45,-49
23c4dddb023ba23181b00d1eb752a61a297808b2,org.apache.tika.parser.txt,7,5,47,2
ee2c3b90b736e3ccaeaf204a658e917b87d378df,org.apache.tika.parser.txt,2,2,47,0
6d37de9d208f1f7918df6f81a14a1d3b48a4d37f,org.apache.tika.parser.txt,3,1,49,2
62e58ea2e8ccd2ef1a968349408c990914efa6b6,org.apache.tika.parser.txt,1,3,47,-2
7d91d377a95febaaed68252bf7efaa3c2579db6f,org.apache.tika.parser.txt,103,8,142,95
c943f692982b70a43b4ddec37bc40e2a3de2d318,org.apache.tika.parser.txt,37,9,170,28
a328f9c6ad676d51c34c7dd8584bac72438f99dd,org.apache.tika.parser.txt,3,31,142,-28
4c8f0b8fff933890990c336e40ff5a419d08321c,org.apache.tika.parser.txt,2,2,142,0
3a743efd63e737bfa0ef621923f6c9a2b7c1e50b,org.apache.tika.parser.txt,2,3,141,-1
64e1e5180b49b78fa4559b3d88503e6d9825483c,org.apache.tika.parser.txt,8,12,137,-4
7d8686cb5e5ecf6d5a7268f8f3517b49440eddae,org.apache.tika.parser.txt,2,2,137,0
8dfa33c3d14561923e29da234700278911be0efc,org.apache.tika.parser.txt,1,1,137,0
12ec68e67fecb7008f0fa2dab9c1679cdccf6cf5,org.apache.tika.parser.txt,31,2,166,29
d9493ee520d41bfc8be8a3bd959dde6e136729e7,org.apache.tika.parser.txt,3082,3,3245,3079
f04edc5024a25ce5ce6d178fd8027b62ecc58b40,org.apache.tika.parser.txt,36,1,3280,35
296e279858af9112d5500cc9a828a2d87d3218f5,org.apache.tika.parser.txt,71,35,3316,36
3922b01361d5958a31c199e376e7a979a3a6d376,org.apache.tika.parser.txt,14,1,3329,13
c9dfb89f029fe349a6057bec88d838b0200b9337,org.apache.tika.parser.txt,15,9,3335,6
ad11aac0a56344521d33306b36f645f984173531,org.apache.tika.parser.txt,3,5,3333,-2
afa3c1fbe203dc5b202abb464d74c6527c521930,org.apache.tika.parser.txt,78,20,3391,58
2354fe66ca0c7b6e16c8dc7b44bd73eaa975c057,org.apache.tika.parser.txt,44,3,3432,41
16db6681ebfcbb622255f81f5006020af07c2d1e,org.apache.tika.parser.txt,20,2,3450,18
0678c44ba5907840311ca3239d6aa232d55c1c49,org.apache.tika.parser.txt,6,11,3445,-5
3ad79a6a21e0039fb451044b2b9e71f83f258311,org.apache.tika.parser.txt,6,7,3444,-1
33171a5635184bfcf54afccd72b0dee0529f9f0a,org.apache.tika.parser.txt,9,0,3453,9
05acb51341cf2fd112ecbc8da517a33141b3a434,org.apache.tika.parser.txt,5,18,3440,-13
9f5593e6990fddc3471e1b87fb1df2f00c5ed600,org.apache.tika.parser.txt,78,2,3516,76
23130229db0f0e0052cc7b01fe7ffc5855ebd636,org.apache.tika.parser.txt,22,0,3538,22
7857da16f157ea7722e575f40cedf08238a25111,org.apache.tika.parser.txt,1,1,3538,0
3b61cea5aba160f9289db7d913aec2c00c3b7a6e,org.apache.tika.parser.txt,2,11,3529,-9
eb73a4be05f53e33679146810c28e74224f8b359,org.apache.tika.parser.txt,137,0,3666,137
aa944e848894e16adec24eeffe29e11b96ad29a8,org.apache.tika.parser.txt,75,37,3704,38
65a5b2030ed3c1043227141ed9dcfc43e22f2b4b,org.apache.tika.parser.txt,1,1,3704,0
2e976ca42e1beae14a706e9461f59e078f4d3704,org.apache.tika.parser.txt,4,0,3708,4
6673d51674946be52905ad5b448ba2051092fe19,org.apache.tika.parser.txt,3,5,3706,-2
a157a6f025c4b5eda63881124919b4271f85ba0b,org.apache.tika.parser.txt,6,5,3707,1
f8e3364bfd7fa5d4d80c7b249894ebbe6a146b85,org.apache.tika.parser.txt,49,1,3755,48
89dc4d725fc4a1dd3406c462bb0e2b8575c5d34f,org.apache.tika.parser.txt,4,3,3756,1
6bc0537b260d826bbfc6cf04d06963b86e230d72,org.apache.tika.parser.txt,204,37,3923,167
8756776cd711c78f7cbe9d2fd7688bbc97ae290c,org.apache.tika.parser.txt,59,18,3964,41
929c8972a112ac75e5bec8120f0df5d7e5d5ec60,org.apache.tika.parser.txt,85,104,3945,-19
6621297537770ca9149e06ee2977483009f8860f,org.apache.tika.parser.txt,73,130,3888,-57
9ead13fb86b4476f79359bfc20735b2201c752ed,org.apache.tika.parser.txt,163,64,3987,99
89941a2ba1e4b13c3de9c5cf050e4dbf1edafca3,org.apache.tika.parser.txt,1,2,3986,-1
b8beefd21e5b33dd824baca096080668e7cff27a,org.apache.tika.parser.txt,5,61,3930,-56
7d89a5e455686a945f2e3302f0d201e5e6c4a985,org.apache.tika.parser.txt,93,47,3976,46
069305bd4d62a0767135dffd005e8c95ca83ba43,org.apache.tika.parser.txt,23,0,3999,23
a64d33c78c143f401d2d7ef795872fcc35fb2200,org.apache.tika.parser.txt,6,1,4004,5
7260050594e7a13283d2dbfd1a079149a63d43ac,org.apache.tika.parser.txt,2,1,4005,1
03f762554f7065f939d010669fbdfe4bc362b501,org.apache.tika.parser.txt,2,2,4005,0
2a36fcd63ddd3234b7f34e6814972bb62aeb4bc9,org.apache.tika.parser.txt,18,3,4020,15
a360ec5add94fad571114f6090e363df6c9295e7,org.apache.tika.parser.txt,26,0,4046,26
424c0ebd503900bdff481e059a3a326dc7add814,org.apache.tika.parser.txt,3,3,4046,0
50177e6e9223e0f15f7f9e0c4c8064320b7b2968,org.apache.tika.parser.txt,0,2,4044,-2
79211cc7a400f3b0b066f0a6401dee1c2fa9c90e,org.apache.tika.parser.txt,5,6,4043,-1
89eea5fd18f92e8280abeeccb09556e3dde271f3,org.apache.tika.parser.txt,6,6,4043,0
892f3a8b1e44efdf86ec9aed0887de7afcbf01ea,org.apache.tika.parser.txt,5,4,4044,1
5239ee7922c52a6a5281f3671ee9b31f7707f5bb,org.apache.tika.parser.txt,1802,1975,3871,-173
19eb4448304abff6322d830ccee7ed868d443d71,org.apache.tika.parser.txt,1,1,3871,0
d5981c7079c23c58dbb91aebce30de5498f51b8a,org.apache.tika.parser.txt,12,11,3872,1
8938fdfa93f8c0647e547e8a04a187fbb5a32603,org.apache.tika.parser.txt,4,15,3861,-11
d698d49793bb96aee6a8bfcc4a174c922cb83cb8,org.apache.tika.parser.txt,833,893,3801,-60
bd9a9b911b4e0205c9dfd4527063e6e1c0fd0c44,org.apache.tika.parser.txt,152,16,3937,136
d50a69361bd0196fb2595313cb47222f61701ba4,org.apache.tika.parser.txt,846,770,4013,76
415381212291e843e9091f43f6db8c432eb02aa9,org.apache.tika.parser.txt,21,5,4029,16
2dbd65122a477c1b7a61d88e4fdf25a3d47effcd,org.apache.tika.parser.txt,10,3,4036,7
6d022be03b5423f6c036e1aa45e4ce02a9678462,org.apache.tika.parser.txt,57,8,4085,49
e7a0c3eece98ac81b3813aeb429b24f16090201c,org.apache.tika.parser.txt,9,29,4065,-20
e56e2b2915e8cebcf97c69cdcb3ecff861434f61,org.apache.tika.parser.txt,912,784,4193,128
1f38be359b2735de94e9ae5850a3622e5393f77b,org.apache.tika.parser.txt,24,9,4208,15
40e99f986f9cd8ab390f189a484c42e81994a911,org.apache.tika.parser.txt,24,9,4223,15
d5d739c237c677c49d64b3766700ce506c5982a1,org.apache.tika.parser.txt,24,9,4238,15
94850f2e7c7d3df6a06a924fc6d643c0f6181643,org.apache.tika.parser.txt,59,17,4280,42
b5f5403fb150f2a290fe1cfa10a6fe572b1dd50a,org.apache.tika.parser.txt,78,21,4337,57
c009dc71cc8428e0a752100af7e9d18d7e5e3096,org.apache.tika.parser.txt,54,8,4383,46
8e33e28b72b791710a1e9fdf515c2fcd72f82deb,org.apache.tika.parser.txt,1,1,4383,0
b329820804bb74cc290337041eee595395e77435,org.apache.tika.parser.txt,2,2,4383,0
f9104d17ad0b92b243501fdf0863b4ccdaa5e791,org.apache.tika.parser.txt,912,912,4383,0
b5c3485e9f1c390565ccc0abc5e4609fdab9bd0a,org.apache.tika.parser.txt,3,1,4385,2
e9ee34d9530e28e95d8547d2034eab8323f49ad9,org.apache.tika.parser.txt,1,1,4385,0
f29362d91b46864a7f924c60f7cf691ac18f11b2,org.apache.tika.parser.txt,2,4,4383,-2
7595d820633d2588234b6650ab36265a4dcdfec0,org.apache.tika.parser.txt,2,4,4381,-2
faad4c316634880df054dc6178e18f172a132d4e,org.apache.tika.parser.txt,2,2,4381,0
37f0559c28dd485557f5d66e9c0fe6cb6123b225,org.apache.tika.parser.txt,2,2,4381,0
eea92fb045759300825ed6a727484df17e81e60b,org.apache.tika.parser.txt,14,1,4394,13
8dbb5736fa92b323e270e2075b42dce458a3abd6,org.apache.tika.parser.txt,0,1736,2658,-1736
a43784b19f6b0955478dded71521b0491d21c90b,org.apache.tika.parser.txt,1736,0,4394,1736
0dd035b9be57a71ba23a29120f1e2153a3178b5b,org.apache.tika.sax,234,0,234,234
2e18733f93866c5670c0af0d0b88262508882f8b,org.apache.tika.sax,5,1,238,4
5e97d465816ea70aa29b883487ccbd30622c3b26,org.apache.tika.sax,750,1,987,749
b2b79ce6926dfe1b8e8ff13de8188f7650ee50c4,org.apache.tika.sax,7,0,994,7
80866ff406ba6dd79c94def3703b18dfaf8128a6,org.apache.tika.sax,2,2,994,0
5cb14dee4de65994c9e0734ff69f0bafe7abdb6d,org.apache.tika.sax,44,0,1038,44
68628ea2173da55de9d767d17fd61558d4b140f7,org.apache.tika.sax,8,0,1046,8
aa271eff08076f4d1ecc69e0726f80f17c604e33,org.apache.tika.sax,41,14,1073,27
2907d8fe7dd0ff4782d3ade89e90dffdc553441f,org.apache.tika.sax,54,31,1096,23
64e1e5180b49b78fa4559b3d88503e6d9825483c,org.apache.tika.sax,132,238,990,-106
9b506beebeb582e643e24a842c3729e212dc5091,org.apache.tika.sax,19,4,1005,15
e889dfad07ab4a8f8a1352dd5b0fd2b5ce18215a,org.apache.tika.sax,5,1,1009,4
6abd44bb7fb419c197325041c4a3ff74827c45c8,org.apache.tika.sax,1,1,1009,0
8dfa33c3d14561923e29da234700278911be0efc,org.apache.tika.sax,81,3,1087,78
3079789724edf724c492c3497630c3cbd5533ef5,org.apache.tika.sax,945,945,1087,0
27fdf2ce6987a55e7a5bab7b83deb203eab7621a,org.apache.tika.sax,115,0,1202,115
f969a260ce7f02f2e431dfa6dfbcd5ac0c7bebf8,org.apache.tika.sax,79,79,1202,0
3c15d9cad408753ab0faea4fe1fa1be1408fa7c2,org.apache.tika.sax,70,39,1233,31
e43a19e433b6085b91bf44f534dbf055db313026,org.apache.tika.sax,134,16,1351,118
717833ad539511dc9c48eb488ce88c4337b05651,org.apache.tika.sax,192,0,1543,192
235e80743cc75d3812c1fa59deb35df4a4c2af6e,org.apache.tika.sax,1,1,1543,0
aefe614e7c4846b173e102e1e99af03dc9d35e01,org.apache.tika.sax,38,2,1579,36
a9fb61439bf092318680fde1dad4e9d91aea96af,org.apache.tika.sax,157,74,1662,83
e77e233f0e74edc6271a5dad2c8b1a7fe22925e2,org.apache.tika.sax,111,0,1773,111
2699cf47e222d61b5c4f5ab0757c63199e3fd62a,org.apache.tika.sax,15,1,1787,14
60c9b0e05868fb786180b3d7403537b2e66dce03,org.apache.tika.sax,10,0,1797,10
f29a52ab58074b37d6bd56d73236f2b6cef1aaf1,org.apache.tika.sax,209,0,2006,209
b22616eda532f4562718340eec22aefbcd9037f5,org.apache.tika.sax,148,93,2061,55
1c0109f83e030606388f2d6c300e138c2d881f9b,org.apache.tika.sax,35,1,2095,34
6aaa141c4dec173f995df16c4f4fcd86152edfe3,org.apache.tika.sax,258,12,2341,246
26a8225e5b2fc785fc69b1de9eeed807ffdad580,org.apache.tika.sax,1,0,2342,1
87a45f986b228e897203a410a3edcde00b9b2d12,org.apache.tika.sax,5,5,2342,0
03be219a6d7646d07c56b1cc98899d139cb62727,org.apache.tika.sax,1,1,2342,0
ebe7995a870c96ad5a7c9b05ed24bdb940bd166a,org.apache.tika.sax,19,35,2326,-16
d569761e7a729085ea47db39f66ea7ce7bfc130f,org.apache.tika.sax,0,1,2325,-1
4400e3a866d2b4649eb23c251a7b887e977de167,org.apache.tika.sax,98,8,2415,90
b12228176d847064d8b48a6af82b9bb47b3d6740,org.apache.tika.sax,13,3,2425,10
dd6330f7dfa0f836918306ee718e48f9c4418dbe,org.apache.tika.sax,5,0,2430,5
a2d3c00607edacc3bc8e3ee801d972be2542c2c4,org.apache.tika.sax,23,1,2452,22
486281b69d4d0f83ec4c35b85514b18b90a17eb8,org.apache.tika.sax,92,26,2518,66
a1c050381e3cd2fff0ee9144f2d867d0491a1cdc,org.apache.tika.sax,3,2,2519,1
163d93c4e1e78a27b5dcd9502c2a4757fbd53b7d,org.apache.tika.sax,27,12,2534,15
e347b9887b6f02c00082c393b5a80d2126539995,org.apache.tika.sax,9,5,2538,4
61f707fbc6b35d544de3d1cd420d0b3d8c63ed3c,org.apache.tika.sax,76,0,2614,76
c1f7fd7e5de2c31eddf9b0df086d214ea9adf08c,org.apache.tika.sax,260,260,2614,0
bc3fd0722e3f07ba18c54af7108f9f82cd9ea0d9,org.apache.tika.sax,442,442,2614,0
8a5f28845f28f5a5e2debdfc0fa3f89c738cd2fe,org.apache.tika.sax,59,1,2672,58
1c04a002b2edf74819377c49ca0ca0172a8063eb,org.apache.tika.sax,198,23,2847,175
024bcc49b20c07205dffba1b6c32f79b73915a26,org.apache.tika.sax,3,3,2847,0
3dd12110dad0e5a71555d4e4a0e5a6cd609b0fb7,org.apache.tika.sax,6,6,2847,0
00afd536d98a496ae88c523a9e0d511e6b765538,org.apache.tika.sax,10,1,2856,9
46dce5b798874e3b1130ad3f39308d89068b8d52,org.apache.tika.sax,5,1,2860,4
ac4b6ef8f4bc4cdf93d062c0a55a0e43007cfef1,org.apache.tika.sax,53,0,2913,53
c2f7fe03d7bbaf0ce42f9c0ea08c0871f39a9c24,org.apache.tika.sax,11,12,2912,-1
406cca3479f95de7543c59d8bd31856409b701b3,org.apache.tika.sax,19,4,2927,15
7fe73eb240c66af99556bc3420372b19424b7527,org.apache.tika.sax,64,8,2983,56
b16c8987e6910aeff242ce364753e6eec5eafafa,org.apache.tika.sax,5,1,2987,4
9c9763a5ac67683553f155a33338bdf98e1a6937,org.apache.tika.sax,100,10,3077,90
4c5599b6694a31e8ce84a1a0d88100827d98490e,org.apache.tika.sax,4,4,3077,0
5c22595f655362f983e73aca4fb79149f37a17ec,org.apache.tika.sax,58,0,3135,58
c4c8b2247dd90e0f5ed3b9eac6da471e013989a8,org.apache.tika.sax,44,0,3179,44
de3538527dc7658735a7544c9f904007bc180021,org.apache.tika.sax,0,0,3179,0
ab1aea62e8c1a20652c004c55bffea83b8f7eb60,org.apache.tika.sax,3,0,3182,3
fcde81cfbf6f7d4a7ba4e148471f1ce622d59f92,org.apache.tika.sax,590,71,3701,519
77ebfcd04dfb16f9f856dbcf6fe9098217c779c3,org.apache.tika.sax,98,9,3790,89
cbd8a3191a02af85c34da9f0bf68184a2ddb66b3,org.apache.tika.sax,5,5,3790,0
84d1ee3915c676005fdf741b2f18d7917761465d,org.apache.tika.sax,89,5,3874,84
578050ca86cfef2ba957813a28d19870d5220653,org.apache.tika.sax,8,2,3880,6
5cc8b40243eee50c5364c8f350d1a873cfab8180,org.apache.tika.sax,152,0,4032,152
25f7a4d5dac3b7d4bebaed41ef43bf37d1e86814,org.apache.tika.sax,0,7,4025,-7
e910698ed42888d0c30dde88f2ceac7b2f841b98,org.apache.tika.sax,2,2,4025,0
52d51b91d4b288db5887d592826abbbec5cd6db5,org.apache.tika.sax,32,1,4056,31
f52da719f16ad7379d5b7019ac766a80ab48d6db,org.apache.tika.sax,3,1,4058,2
6a8b23bf65adba79c60e8d1b0e21e2d6fdef59fd,org.apache.tika.sax,18,0,4076,18
9b94789f2e9d759d4f6523b3cccd8370831e2469,org.apache.tika.sax,2,1,4077,1
df5371364f9dc5f502e0b455dd1ab3771579754b,org.apache.tika.sax,89,2,4164,87
39a63cad3ad912f412f75a2dcdca400ab8e37ab6,org.apache.tika.sax,75,0,4239,75
1e785151730deb210bbd72f96c8f3a599a24382e,org.apache.tika.sax,16,0,4255,16
71166dea776a676601d35bef3922717aa2d56301,org.apache.tika.sax,17,0,4272,17
2db38125fb23d9ddfdf64a0cf18dce677a74499c,org.apache.tika.sax,4,0,4276,4
9227e9f3d5090be28e28639ab92732c5be0507cf,org.apache.tika.sax,8,1,4283,7
2a36fcd63ddd3234b7f34e6814972bb62aeb4bc9,org.apache.tika.sax,81,27,4337,54
30523c07111cdef29c7e29c05eed17c75bfa6e04,org.apache.tika.sax,12,3,4346,9
8fd76a41b32b80353820d4a8bdaa08de5529f7ee,org.apache.tika.sax,5,0,4351,5
6cc0e11b91ee5ebe97ea91fc50a76074f45829c2,org.apache.tika.sax,5,3,4353,2
853df89a08ee8dbc96b2620aa907c66f699233ee,org.apache.tika.sax,158,0,4511,158
5be919dc54728496fa7d5484ad81af46a3f1ddc7,org.apache.tika.sax,1,5,4507,-4
e2293d302bc5f447563c5c6c93907b55bba6e91b,org.apache.tika.sax,339,16,4830,323
65977bba2a5900c43dbb9f4c8512daf38b9163b5,org.apache.tika.sax,641,641,4830,0
83b8f79c71dde3f45097a047d8fdf4fd4cf66dfb,org.apache.tika.sax,47,29,4848,18
892f3a8b1e44efdf86ec9aed0887de7afcbf01ea,org.apache.tika.sax,9,6,4851,3
2697354c7e50b9b06c44441accd09f3cff594c6e,org.apache.tika.sax,22,1,4872,21
fa5eb09e95e77ee16424cfee434800dbf801d9c4,org.apache.tika.sax,0,1,4871,-1
7ca5ec0aecea4092b6a8399638444ae4a335137c,org.apache.tika.sax,152,0,5023,152
88f140f5cfd63202a48bab7a43e2c6cae05ea8da,org.apache.tika.sax,641,641,5023,0
761273f9e69c4a7595e50ccd6a2d9304c398d0b1,org.apache.tika.sax,183,89,5117,94
fd8514c2c512d9dcc1039aadf1dbc64c1ff6d3fc,org.apache.tika.sax,89,183,5023,-94
4dcfb74cf702aa88a94f58ca79ede313dfb45852,org.apache.tika.sax,2,2,5023,0
f71910e2e00b55fbfd339e6d682521f64de0c696,org.apache.tika.sax,4,4,5023,0
24b8c2a918ac599b5aff1265f2e08014de1a2fe0,org.apache.tika.sax,29,1,5051,28
8938fdfa93f8c0647e547e8a04a187fbb5a32603,org.apache.tika.sax,1,5,5047,-4
f43de5a24b56cdd6a3c5abc3e5a38e2410089d69,org.apache.tika.sax,18,1,5064,17
fe841bc8760027eae3f9d0105238780815451346,org.apache.tika.sax,53,4,5113,49
3b7922db1a2e72181e1a00168d2aee33bfe1d4a3,org.apache.tika.sax,87,0,5200,87
1882defb38ed244d667114399ea31e6b938c31b3,org.apache.tika.sax,75,0,5275,75
0dbd69cef5ec603a11d7f5b52f119e3bea1550b5,org.apache.tika.sax,75,0,5350,75
34db93595c71745e3bccdabc39e72181c03abbbd,org.apache.tika.sax,8,0,5358,8
1c5e96cf617b231ce8d902fc86eca84edb9cafe7,org.apache.tika.sax,58,6,5410,52
da1fe243ace68cc2b5c4bde022113233ad95ea15,org.apache.tika.sax,66,6,5470,60
80b27e6d843d221de87591d34632e546c0d23b1a,org.apache.tika.sax,58,6,5522,52
9024f12e0fbef206330b6317a537354fafbe9cd7,org.apache.tika.sax,3,2,5523,1
e780d56652d48dd0f50b4e62a58153e95f055022,org.apache.tika.sax,66,6,5583,60
d50a69361bd0196fb2595313cb47222f61701ba4,org.apache.tika.sax,3,2,5584,1
abfc826959a099d6000365ccdec23925f041043f,org.apache.tika.sax,4,4,5584,0
e56e2b2915e8cebcf97c69cdcb3ecff861434f61,org.apache.tika.sax,7,6,5585,1
e76302196ebcafb7b51fce37fbe8256e6c0fbc51,org.apache.tika.sax,634,0,6219,634
7b869c0c1b132feb691dca645fe9bc689bf320e2,org.apache.tika.sax,21,6,6234,15
31625a2ad6b9a4de73aa322845fb1e38ba96177d,org.apache.tika.sax,2,2,6234,0
b5f5403fb150f2a290fe1cfa10a6fe572b1dd50a,org.apache.tika.sax,649,0,6883,649
4fdc2b7247a033defed10874eecb986778ad451c,org.apache.tika.sax,2,1,6884,1
690855f11b08f97e5849d5636e2067dbfdbfd4ac,org.apache.tika.sax,2,1,6885,1
d26fbb8b9be03567bef61e3ed2af2cd6ef4a677e,org.apache.tika.sax,2,1,6886,1
257ee161f9b6b9ea8a52dd52d71779479d9af254,org.apache.tika.sax,1,1,6886,0
5f05b511d7d1184f6f25a2b644b615c4f21b8e68,org.apache.tika.sax,283,29,7140,254
7536ed91afd9a3fe744464e34f95f3108c6bd5a2,org.apache.tika.sax,6,1,7145,5
18f4e24451b1d835ab1897f49389788f78063a52,org.apache.tika.sax,6,1,7150,5
0edd73e7ce6f32cafb9554eb8bbca76c413efa1f,org.apache.tika.sax,6,1,7155,5
0e8f44459fbbed991171e9eafb3395df6060fb7a,org.apache.tika.sax,7,2,7160,5
5ae7cc5d59006e15baa3347954e0545468c0dc94,org.apache.tika.sax,2,2,7160,0
cb1bbc052188bf5e45e5dc17570180df1fe27df9,org.apache.tika.sax,15,5,7170,10
c844fc3928516f710a1e62ab99c4eb3f8ab27410,org.apache.tika.sax,1,1,7170,0
89a588e4d8d2aa44a9d3c965d514c18c7d3c134d,org.apache.tika.sax,33,2,7201,31
e7b481dd763ff4f586a94b981281923e4604010a,org.apache.tika.sax,49,8,7242,41
5a4a0eecf61d7ced2a708d0184df5179c125dd4b,org.apache.tika.sax,1,1,7242,0
6b5dd8bbe09eb099ec75846ec02391cbd32351c4,org.apache.tika.sax,42,1,7283,41
1ac6a3bd8601dc3376ce01786f115b877b9d338f,org.apache.tika.sax,5,0,7288,5
1158d893dc952c573f7a12c7e4855cdce479fc2a,org.apache.tika.sax,9,0,7297,9
dad1c722ceb7b8583f878d5e5bba88325f5f3530,org.apache.tika.sax,4,1,7300,3
0f5c16e57f85cc98ced6b52e52b1e84d53b66ae6,org.apache.tika.sax,53,0,7353,53
313ef8b53ad3bba3f0910bcfb25db683ba6ba209,org.apache.tika.sax,10,13,7350,-3
ff762e6c262aa830235b1fe302df474ba4a5cf5b,org.apache.tika.sax,0,3,7347,-3
3d2afec4ed10c8853d69f75e2bebda7490975c94,org.apache.tika.sax,6,0,7353,6
3bdcd9714b8259c7c8c2ae1d5837148016d5bdaf,org.apache.tika.sax,28,3,7378,25
bf224dc2f09c029df3f93ae0b136eb294e2c233f,org.apache.tika.sax,28,3,7403,25
f9104d17ad0b92b243501fdf0863b4ccdaa5e791,org.apache.tika.sax,30,0,7433,30
f29362d91b46864a7f924c60f7cf691ac18f11b2,org.apache.tika.sax,1,1,7433,0
7595d820633d2588234b6650ab36265a4dcdfec0,org.apache.tika.sax,1,1,7433,0
e8e2c6bdf0ad50d8726df527194e4f104d4c79c0,org.apache.tika.sax,6,12,7427,-6
b417bf73345c0ae131270c36b64f6555f94e8168,org.apache.tika.sax,6,12,7421,-6
faad4c316634880df054dc6178e18f172a132d4e,org.apache.tika.sax,2,2,7421,0
37f0559c28dd485557f5d66e9c0fe6cb6123b225,org.apache.tika.sax,2,2,7421,0
7ed64a5bd8e564bbe8fce0948a71c1db249fa2fb,org.apache.tika.sax,2,2,7421,0
6401ca084ac9409bf6b6c94b2fa4ff293e427133,org.apache.tika.sax,2,2,7421,0
82cf5c0bf0874ccd4c4d66d9eb54912438a09290,org.apache.tika.sax,56,0,7477,56
8dbb5736fa92b323e270e2075b42dce458a3abd6,org.apache.tika.sax,0,53,7424,-53
a43784b19f6b0955478dded71521b0491d21c90b,org.apache.tika.sax,53,0,7477,53
92573a191fc1f4968b643c5c83489886fe9d8bec,org.apache.tika.server,1042,0,1042,1042
bbc97d84dc5540a881eed5a4e14b15747b3f5eac,org.apache.tika.server,0,11,1031,-11
3b61cea5aba160f9289db7d913aec2c00c3b7a6e,org.apache.tika.server,2,7,1026,-5
25ca130ce5363c324d54b6006739081691583265,org.apache.tika.server,167,111,1082,56
49613a107d84c1ac7d295f2e54506342784c5adc,org.apache.tika.server,0,4,1078,-4
8618f64178761414c9b2919bf3abec06c3b4c24a,org.apache.tika.server,4,4,1078,0
2c25c2a8e4aa15e033e0cdaf7e36cfc41959792c,org.apache.tika.server,13,10,1081,3
830f702d509197abd15e91bcacd40f1287a6dc0d,org.apache.tika.server,48,20,1109,28
44d14a51ff1c93fc597aa85fc828507d214269d3,org.apache.tika.server,374,218,1265,156
93ab990cd392631cb51e89711c4850d449df0491,org.apache.tika.server,567,362,1470,205
27163d3bc04713e194e115b2e3610bfb5d116d6e,org.apache.tika.server,5,3,1472,2
abb7e351a23a9855a76066af8a014402c844b103,org.apache.tika.server,154,248,1378,-94
f906d346e235a2317c583975339d8dd3fea74591,org.apache.tika.server,4,3,1379,1
a1e4fed9b35fb377991758f4cb25f340f4b081b4,org.apache.tika.server,1,1,1379,0
0b8f59f622f248bbd039012a91b68b6f82048771,org.apache.tika.server,5,3,1381,2
7b42120d9f8f7b009f6ece479d67c934076b7f47,org.apache.tika.server,1,1,1381,0
d53f02f4c76495e26f0ce77cd2007fec1385ada5,org.apache.tika.server,142,9,1514,133
562dd39cd13f790b864e0d954ef8be8bfc47bf48,org.apache.tika.server,42,14,1542,28
1b7871d2a5cf7de542943038827709c69ea861b9,org.apache.tika.server,413,0,1955,413
3e18897b431e606cccdc615eb357d95b4c5d3e40,org.apache.tika.server,73,0,2028,73
a6d2100e6ed867ecb76a8f83c952792d25c174ac,org.apache.tika.server,2,2,2028,0
88a0702ced2f41e05452004a8b80c2b23d54a32a,org.apache.tika.server,2,2,2028,0
f50544d916483e18886f8809722f19dd3f108ddd,org.apache.tika.server,98,0,2126,98
9d81bddc52fc3eb851f52099263d28b18bacde69,org.apache.tika.server,180,89,2217,91
6f7177ff791539fd277e7dc59e0f7fbe5e3f0e5a,org.apache.tika.server,82,49,2250,33
f708b84da1cd1721deffef7f043eb3f6ba8d1342,org.apache.tika.server,124,115,2259,9
2a36fcd63ddd3234b7f34e6814972bb62aeb4bc9,org.apache.tika.server,51,73,2237,-22
57583e80b5f99b04375b00c578dbca3ddb2089f6,org.apache.tika.server,1,1,2237,0
e085bf2adf721fd107a08cf64923859fd4c46f42,org.apache.tika.server,11,9,2239,2
91ec25677bbb53dab3fd060b471b57a38a0bb5ef,org.apache.tika.server,49,71,2217,-22
556ee2ad852fde5c45ee481809df30862977aa65,org.apache.tika.server,1,1,2217,0
fb1d4b67e45827461b5a656e5f067e30a35ec7ec,org.apache.tika.server,20,3,2234,17
c4efd41cde39612f0fa98a7818f3aeaa45a267d9,org.apache.tika.server,78,32,2280,46
0d2fe299993ebab5c28cf4a8bd145bb16cbeee66,org.apache.tika.server,109,183,2206,-74
3d60db6f6bc83eb975d133b846bc6e682dd0c8af,org.apache.tika.server,4,6,2204,-2
702b819dcb5f54f0f4d0328c0f502aaea0f26a78,org.apache.tika.server,216,10,2410,206
b17a97ebbae4e0e9349df16d55ea4da85c2e24dd,org.apache.tika.server,117,29,2498,88
f23511c7045796dd26d9525abbfc576d37db38c6,org.apache.tika.server,133,2,2629,131
5954a1d884153c47a7734e312ec5a7b9e1a95e54,org.apache.tika.server,140,0,2769,140
61617abc059de92c1862ea9733cc3b4dd7fe9bae,org.apache.tika.server,87,28,2828,59
1e2af4e013e0b7f252238132c4c6e77827049a59,org.apache.tika.server,151,1,2978,150
306cf13076968893f5498a32d1416c8450975066,org.apache.tika.server,118,6,3090,112
dd20615aa41c9e4cd1e9b5f70d680132d24cc57b,org.apache.tika.server,2,1,3091,1
7d524cb50c51b4257a7e96b204fdc46a1aa09b42,org.apache.tika.server,41,8,3124,33
f1aee6fa84916b0e3584b75df1a8fd7e91f3b768,org.apache.tika.server,181,2,3303,179
14991add8ca94238b07b98b341febf67b6e5fbb7,org.apache.tika.server,286,39,3550,247
aacc74d026ce20cf50b4e7de0b7b8032ab287f7c,org.apache.tika.server,2,9,3543,-7
4fa1d2a8c863e79810fc21961e04dcfa75450f93,org.apache.tika.server,16,26,3533,-10
01c9cb5aa566f4f8707316895a95631a060519a4,org.apache.tika.server,5,3,3535,2
55d95c58178812ec317b82e89a43cd9e1c00f4cc,org.apache.tika.server,3,0,3538,3
583af266a28f6494c29fcd62fa78fcc32199cc2e,org.apache.tika.server,178,1,3715,177
cb9cbd5d1db1e26d8a96b1ea5ddbfe9f62f628b1,org.apache.tika.server,2,4,3713,-2
b7e764db6f265a8cfa589226bd7bca96634eb5dc,org.apache.tika.server,11,11,3713,0
ed355dd561963ab4eb6cc9423e4b86e4e817f26e,org.apache.tika.server,9,11,3711,-2
4e1ce480f1eb749e2cf4629adf60f524cc331672,org.apache.tika.server,8,29,3690,-21
3de8dbf642b733c475bd992b0df9e3ab9da21377,org.apache.tika.server,29,48,3671,-19
aa2024a25148894155757f70e241394a9ced5b64,org.apache.tika.server,21,0,3692,21
95051f2a352f3e7ee83acf203d75b803a26c3f4f,org.apache.tika.server,69,1,3760,68
3b004508773ee65ff2de9e90e12d8926b1a52489,org.apache.tika.server,1,1,3760,0
6cc0e11b91ee5ebe97ea91fc50a76074f45829c2,org.apache.tika.server,13,5,3768,8
91d1f000bbf63fa5fd56299763ef4d6ada7e878c,org.apache.tika.server,7,7,3768,0
190e17adb441b3fc2f00319310afd04b8dc08e52,org.apache.tika.server,1,1,3768,0
9005c6760366b29eac19e307f943dfe6f1e522c8,org.apache.tika.server,49,31,3786,18
74c231a575c9ac307b617c2c322d0f4151baeb64,org.apache.tika.server,66,31,3821,35
04253d48ad29bbf3ca81fe300da53da304e9a818,org.apache.tika.server,20,12,3829,8
8b0665501dd6d715bb7a42df6f910d835b87c8da,org.apache.tika.server,119,118,3830,1
8b433c7e222d3980578bbbc1677777d1b8003d31,org.apache.tika.server,48,2,3876,46
57db5ef21c95f49aa19b9da69a69d27a2a1da5ad,org.apache.tika.server,284,0,4160,284
05eef80426e98800791bc6394f20d6bdea2fa18c,org.apache.tika.server,2,0,4162,2
f776fc07aecdf4e97343cba7ee7d35d1cd9743df,org.apache.tika.server,150,43,4269,107
f13e537971b9f5f7dbd1f3aaf94f1dc47467e99d,org.apache.tika.server,10,0,4279,10
e3fbbfbe54b2aece1d282b57d2ae08863549f20d,org.apache.tika.server,208,339,4148,-131
f4337009b06e3621f68d4e1ecbe80d6eec4425ae,org.apache.tika.server,5,1,4152,4
892f3a8b1e44efdf86ec9aed0887de7afcbf01ea,org.apache.tika.server,67,62,4157,5
a39fc18032eadb31b13502f7d69583ea7407868e,org.apache.tika.server,9,6,4160,3
8dbed10b12faf4c3974d7891914a47d78bfdec45,org.apache.tika.server,23,2,4181,21
dadd8696415f5f77436fbf8d4a0b11e7149205eb,org.apache.tika.server,476,152,4505,324
538de8609f6d13abe1d89b64e41b996cf6b88418,org.apache.tika.server,2461,2437,4529,24
0c81e7a4659c1942b189db7c8342964375cda2de,org.apache.tika.server,2,6,4525,-4
4aab1c1777a314644507d2acf27c814390f685d9,org.apache.tika.server,29,6,4548,23
411248466302763e19608733dcbfb95cdc36363d,org.apache.tika.server,298,241,4605,57
63445bd53dc28dbce233f75daa776d0e39043749,org.apache.tika.server,4,4,4605,0
54ea090fb3352d505cf9eefff51ef9674efd4f65,org.apache.tika.server,3,3,4605,0
a606c944c0ca4379cb6ab658b14b0f9a43bfbe6e,org.apache.tika.server,15,0,4620,15
90bc595d756376cc40ca17ec13cdbae5fb023a90,org.apache.tika.server,32,5,4647,27
42d011125590d8e4237e9caab817fb882fca6d4f,org.apache.tika.server,1,1,4647,0
d2dde3ef0723b3a66cf8e9ab735a7a261b105432,org.apache.tika.server,9,0,4656,9
3e9db56e11340c06c39e71df4d320033eda5810c,org.apache.tika.server,2,1,4657,1
7ada2169584970ab9cc8d032c1571dfae78d4fe6,org.apache.tika.server,2,2,4657,0
3210d79b0330614e8088f31dfaa3712df027d521,org.apache.tika.server,7,1,4663,6
d3c776ce35940cfb5f4b8127d239e580860a5bbd,org.apache.tika.server,192,0,4855,192
a54b37a407abbf72e9ac8f5867f873736757e1bf,org.apache.tika.server,2,0,4857,2
a85081207afc8d5bc7c9a9e9c09ad72b3c6743c2,org.apache.tika.server,202,0,5059,202
0a1ffa962bdb919c2bef73754f40f20106c6c555,org.apache.tika.server,50,5,5104,45
73741e79fb02e73c5a35eaddc8ff77d8312f4d0e,org.apache.tika.server,23,16,5111,7
88f140f5cfd63202a48bab7a43e2c6cae05ea8da,org.apache.tika.server,2469,2469,5111,0
b5a79c85d13ce512fe3346653637d809efeda4c4,org.apache.tika.server,1,1,5111,0
65127bf050c6871fbecdcbf6a7873b3046c0a898,org.apache.tika.server,10,6,5115,4
a7e0a5683d5fc26c39de766dee377c907c99309b,org.apache.tika.server,1,1,5115,0
209b64873106f14c745a729baac6b5d137ced64e,org.apache.tika.server,13,3,5125,10
5132638ec133b3176d8a49fa3458a32bf71ac738,org.apache.tika.server,12,3,5134,9
342dd8faa29046008cd1728dccf800a8dae2eae6,org.apache.tika.server,3,0,5137,3
90a2202b5b4a75e7f673bfb42a912cb97ae6d26e,org.apache.tika.server,177,166,5148,11
98672cdd92b6325ff78c763955a7c045b364095b,org.apache.tika.server,4,45,5107,-41
7f5ef182628f22885863a33f5372c514c82e8f11,org.apache.tika.server,2,2,5107,0
2861eb3f5ec43b991bbe08d95f0854b174758e5b,org.apache.tika.server,4,1,5110,3
b3c9e3f1890409c6d74686703be6ae81986ffe7d,org.apache.tika.server,47,32,5125,15
24b8c2a918ac599b5aff1265f2e08014de1a2fe0,org.apache.tika.server,242,10,5357,232
8938fdfa93f8c0647e547e8a04a187fbb5a32603,org.apache.tika.server,5,13,5349,-8
bbbfaac1b5bbcb61bcb6015a196a8de04174b627,org.apache.tika.server,1,1,5349,0
c42b5ad80e73c93bf3f4be1a7f428db45ebc2683,org.apache.tika.server,2,2,5349,0
1e0159b733dc7a8f48ce8943e1f15046c791349a,org.apache.tika.server,21,5,5365,16
6c0b7906ecbc22ea9adb4c1e5781b0eff561957d,org.apache.tika.server,21,5,5381,16
c5b9cb778acc26e65b908aaaaedc9696141eb2ce,org.apache.tika.server,0,4,5377,-4
3a7a94ca5040eabd90f6060effc517126def3fc1,org.apache.tika.server,34,32,5379,2
f054bcd1a0a57a730ebc53e7a2cfd4215a7526fb,org.apache.tika.server,21,9,5391,12
0bd05cec54c581c971d90380304aaa23c9543296,org.apache.tika.server,2,2,5391,0
f9113be57db9607c0e3710b8560989e0f8f8efef,org.apache.tika.server,4,5,5390,-1
1882defb38ed244d667114399ea31e6b938c31b3,org.apache.tika.server,2,2,5390,0
7ebe007ec03088449f67619ef1e6cb564178b14b,org.apache.tika.server,15,4,5401,11
9cdfc4ae23fe9be3b62c827d3771f7bd713fcc63,org.apache.tika.server,33,32,5402,1
71f8423b0403955265a0726ff3173cc5708518c4,org.apache.tika.server,13,13,5402,0
da1fe243ace68cc2b5c4bde022113233ad95ea15,org.apache.tika.server,13,13,5402,0
20c1cfe8f024bf51a5aeb37656e4566420377868,org.apache.tika.server,33,32,5403,1
e780d56652d48dd0f50b4e62a58153e95f055022,org.apache.tika.server,46,45,5404,1
d612aea850060c7d77124f79c525f68032a11031,org.apache.tika.server,174,19,5559,155
e9e8d3bf2b8b802ce01f23eefbe4b181ae252625,org.apache.tika.server,7,7,5559,0
98d75f692ad91755c28759d9be27b1c43b14b080,org.apache.tika.server,2,1,5560,1
847156ac0f5fa7d4cc06964198359cf594b66d50,org.apache.tika.server,7,6,5561,1
7afcfc702e3097f652a0ea21c368f7632d2abf3e,org.apache.tika.server,7,6,5562,1
67cd6c35007aab2053bd0ee0e83108594f4e09bb,org.apache.tika.server,51,1,5612,50
e8ee4ce7fbdc4fd8d0a496731f2b0a481687b72f,org.apache.tika.server,73,110,5575,-37
6ff825c684236a6e1c8a4f77cbcd2d7fb953870e,org.apache.tika.server,9,11,5573,-2
0d8f030f02830a39e004fbfbd6989128ec2047d7,org.apache.tika.server,82,121,5534,-39
ea19d622bb76d2dab7561d6f9cffd7667b92e75b,org.apache.tika.server,73,1,5606,72
4375a8e185b0b870383d1157c5b56c21b7786dae,org.apache.tika.server,2,2,5606,0
e56e2b2915e8cebcf97c69cdcb3ecff861434f61,org.apache.tika.server,413,172,5847,241
6b174ecbb70d1236bdb9886f86bf94f51d3dd881,org.apache.tika.server,73,1,5919,72
6d710da272285e04d6632b501e0752d020063182,org.apache.tika.server,42,9,5952,33
5410928d740baf6cdcf6ce225f105482f3a2fc11,org.apache.tika.server,15,4,5963,11
f74b089162820b0e80a8217b505164edb1531ef0,org.apache.tika.server,3,1,5965,2
134cb3812aba88152f665c1d14ff65092f21d051,org.apache.tika.server,60,14,6011,46
ebb4bc6d7bf82fe618b7a4b5f4e9b4278b96c0d2,org.apache.tika.server,18,5,6024,13
b618984cc78df5696886404c6579d2bad71e1bb8,org.apache.tika.server,60,14,6070,46
10a8eec119c7a77be76000b30aaffb96a552cc44,org.apache.tika.server,26,18,6078,8
e6e3b8817053e981f3843f1d3b7055b4ae30ed73,org.apache.tika.server,26,18,6086,8
066e60d5d6de8d51124c297410e7a4eca787d143,org.apache.tika.server,0,4,6082,-4
ef049510c4243d6b7d7a1752a198426492c8fd7b,org.apache.tika.server,96,25,6153,71
aff91753cf4bd43a100746270acc7200c742c403,org.apache.tika.server,27,8,6172,19
af06e87f719f3c247d3da4da75e9c91dfbb25706,org.apache.tika.server,49,27,6194,22
5f05b511d7d1184f6f25a2b644b615c4f21b8e68,org.apache.tika.server,29,19,6204,10
2c75ea1d14a7d8bd662337e35eadc85a1931c43d,org.apache.tika.server,119,38,6285,81
e7b481dd763ff4f586a94b981281923e4604010a,org.apache.tika.server,119,38,6366,81
c0fb57d9d20e8eb7cb77bce8742e4566a18f5db8,org.apache.tika.server,25,1,6390,24
de2057b2326aaa68c913e2a4a929538d6cc507f8,org.apache.tika.server,102,69,6423,33
01c53eaa6d709972b03735574aa58dc0abcdc51c,org.apache.tika.server,1,1,6423,0
bf1b2418d47e9fa47e0634825341921d7edd1ee8,org.apache.tika.server,524,5,6942,519
f10c8fe884987920c5332885f414ecd8c06ddc05,org.apache.tika.server,938,258,7622,680
79d9d57cd6dfd79beedcb1fa2f517229e2bd3c84,org.apache.tika.server,1,1,7622,0
b5445be6da15d97467ff9ba6568f0d33ee1bbd81,org.apache.tika.server,24,7,7639,17
daec8dbe6024938ec51a42840f09bb4050c6e3f4,org.apache.tika.server,1,0,7640,1
ea6c0091fe4e03f3a5af34dd17e2288940c5ae7e,org.apache.tika.server,1,1,7640,0
e8e7d7d07244e1bc01e3875df352c386401b0f5c,org.apache.tika.server,9,0,7649,9
a89170f6d5261c62bd59f3229235edc6c2175fc7,org.apache.tika.server,18,1,7666,17
af1929e55a4df2026d1305479788c6791d6da9c1,org.apache.tika.server,109,17,7758,92
c068479d7ed1734f75e24fad24572b99c9c3a4c6,org.apache.tika.server,2,1,7759,1
7e798ef8603bf40ea4a17a125aaff36677478353,org.apache.tika.server,55,0,7814,55
bf75e3950a741452b27205ccec308853dc7bd1be,org.apache.tika.server,1,0,7815,1
d6dd1b2a169500fc0452d2f7ec2a54ba3d31381a,org.apache.tika.server,41,3,7853,38
6a84b5664d705c7b4e4f7d30609e42ad3c6b1d76,org.apache.tika.server,8,6,7855,2
86e997510b44f12dc9f90a68aaf583d5d3912892,org.apache.tika.server,2,4,7853,-2
141ff9ca57cc5ec3a9ca3dcaac1832490ddc850b,org.apache.tika.server,18,10,7861,8
4ea421a7aef5d360ae2011c31d961c3dfbe6bfb9,org.apache.tika.server,156,10,8007,146
0b3ef49f83f084079dcd611de54b1431d15e1078,org.apache.tika.server,7,0,8014,7
8d9061d281f7f46ecae8b902e27c49777ec43919,org.apache.tika.server,109,109,8014,0
536111459c780981b194f6ac159124be6bbffa3a,org.apache.tika.server,37,0,8051,37
a88b8ab64c75869c08701aad9607fc56020c2e1b,org.apache.tika.server,306,158,8199,148
4aae9251b26180377bfa44c3720aa4bfac29b81b,org.apache.tika.server,88,5,8282,83
3b95d8552a038898a28a8864069a540cebc14323,org.apache.tika.server,11,3,8290,8
f2e1937005545da5b9d23683aa0f1c82da1721cc,org.apache.tika.server,27,46,8271,-19
a477d73ac56c169075b5c9ea66bf57be1f3dc672,org.apache.tika.server,2,1,8272,1
e921e69c1a484de3036ed4e5a8654b046f54ceea,org.apache.tika.server,145,84,8333,61
badad88737578ffd2d1f87b28bdc3502b9b4076c,org.apache.tika.server,8,1,8340,7
f14090c803ca0aeb78a291f4719ee71db2be286a,org.apache.tika.server,2,1,8341,1
9bcce8fa5a9d328487a24ef2804b183c9f222158,org.apache.tika.server,32,2,8371,30
e6d1eed58c0cb21a0b0088589b26c4d8b9233efb,org.apache.tika.server,16,1,8386,15
6da017abdfe10ad39cd2e7d6cf87e09d5568883e,org.apache.tika.server,12,1,8397,11
6d384c703505d03ab8b96a3f092e80634ddf00b8,org.apache.tika.server,2,0,8399,2
8257e85ae0849e4ce120d5e1be8a91afac5b557c,org.apache.tika.server,6,4,8401,2
e939504c6240e6e143b470c9eefe8615b3470fdd,org.apache.tika.server,6,2,8405,4
f456f2689545d66fa98c8d6573162525fad38fdc,org.apache.tika.server,0,1,8404,-1
b04477493d3f5f31b695af7f9f505ae8e1f47aa7,org.apache.tika.server,6,1,8409,5
5de02e35731d8958a519a696b722bce4ca1204b2,org.apache.tika.server,2,2,8409,0
5134c7753d93c8e55d994223312e42909b1a9cff,org.apache.tika.server,65,27,8447,38
833630effeefdd60c2319b2f51acb8baf3830027,org.apache.tika.server,34,30,8451,4
80d96a4ae4207324c17e3195f7dd6552ae235152,org.apache.tika.server,28,4,8475,24
7063b7d1b79495a3c390f06eee1ba451155257ed,org.apache.tika.server,1,1,8475,0
3ff613cefde7356f5a4cd2491f7d11f828e59c0f,org.apache.tika.server,11,6,8480,5
a6f74fea25c4c6a8bafd529492d2643a97622a99,org.apache.tika.server,10,10,8480,0
6ea82881dac8191f3bce417adb4a2fabd18ef84f,org.apache.tika.server,13,2,8491,11
00eba49664049acc2b50889bff30308ff76d7342,org.apache.tika.server,18,1,8508,17
4bab6a885b48e1d2b41b2fb305b761145aa92fbc,org.apache.tika.server,126,3,8631,123
a2f35a32fd989e940b70485a8f979ad92a375483,org.apache.tika.server,1,1,8631,0
e2250e0b3ac19dbeda7672102fc648be6644f303,org.apache.tika.server,12,2,8641,10
f53eeafbf141cce9635aaadfffa86cb39ae377e5,org.apache.tika.server,12,2,8651,10
d6a86eebb4183f518abf129e0bca65ded539a82a,org.apache.tika.server,66,13,8704,53
3bdcd9714b8259c7c8c2ae1d5837148016d5bdaf,org.apache.tika.server,146,2,8848,144
4971e2e435ff433f8d489959001b8ff8e05fef7f,org.apache.tika.server,10,2,8856,8
23329a6bfb41098022554f751882e86168a965ce,org.apache.tika.server,181,1,9036,180
bf224dc2f09c029df3f93ae0b136eb294e2c233f,org.apache.tika.server,154,2,9188,152
839d3187b93822dc7b7a8c269f00ac7ebfacddbd,org.apache.tika.server,8,0,9196,8
f9104d17ad0b92b243501fdf0863b4ccdaa5e791,org.apache.tika.server,10,11,9195,-1
c2a25674dbbafaae335d9066ec72bbb294bdb655,org.apache.tika.server,3,2,9196,1
d4a39b4873d939553e0742487b8c84f072497c1f,org.apache.tika.server,16,0,9212,16
b5c3485e9f1c390565ccc0abc5e4609fdab9bd0a,org.apache.tika.server,6,5,9213,1
172d40322f5662e428850ad7a8fb4113e453a51c,org.apache.tika.server,4,4,9213,0
ba20bd5ca446bd2ba49ab9406aeaf48e83a3559a,org.apache.tika.server,175,25,9363,150
120d596beea6efe5f34ecf20e08ce41735d0ea7a,org.apache.tika.server,1,1,9363,0
f29362d91b46864a7f924c60f7cf691ac18f11b2,org.apache.tika.server,1,1,9363,0
6d2312a98cb4d9698c73158c2e28d296756ef959,org.apache.tika.server,1,1,9363,0
53fef890942bdf69d455abbbecc17cd22d6621d6,org.apache.tika.server,2,6,9359,-4
44c0c83971ab5503db4e7258e258a0d3a360594a,org.apache.tika.server,2,6,9355,-4
7595d820633d2588234b6650ab36265a4dcdfec0,org.apache.tika.server,1,1,9355,0
771289445e261210e48fba34f3e298febf19b1df,org.apache.tika.server,30,0,9385,30
6401ca084ac9409bf6b6c94b2fa4ff293e427133,org.apache.tika.server,1,1,9385,0
9ec102102119e6d398c53652e1a28c2c61600f5d,org.apache.tika.server,7,7,9385,0
3571725a948a4676f1904799209271eeaf18b102,org.apache.tika.server,1,3,9383,-2
8dbb5736fa92b323e270e2075b42dce458a3abd6,org.apache.tika.server,0,1,9382,-1
5a278114e19678801c096f3cf557f8321d2527a0,org.apache.tika.server,1,1,9382,0
7fd2825613bce5fd741a0126de8d812a316389ba,org.apache.tika.server,1,1,9382,0
dd85c73094dc87f6f6e208278325be810761f490,org.apache.tika.server,1,3,9380,-2
326b7d7abda238ccc181fc2acaf2271e08fe9c1b,org.apache.tika.server,3,1,9382,2
7f65d61b4fe1f4c1d4929bbe1c456c68afd44b6c,org.apache.tika.server,1,3,9380,-2
6e3ee160366ebd6b336d7b9f12984486a3bb886e,org.apache.tika.utils,440,0,440,440
2b86daf8815f3c8d974f887e4cc064b9159db595,org.apache.tika.utils,26,8,458,18
c47f57cff5a948c12748bfcf63fb34ca4715cc0e,org.apache.tika.utils,32,5,485,27
74f807d5645dc46e45ec62f79ab6d1b51457d3bf,org.apache.tika.utils,37,0,522,37
d7dabee5ce14240f3c5ba2f6147c963d03604dd3,org.apache.tika.utils,41,15,548,26
346d584e25d53c93e808d6b6a19ec5c30068d8d2,org.apache.tika.utils,3,1,550,2
376241396ff4f055188039211af70d9f76c1d4f1,org.apache.tika.utils,433,0,983,433
9f4c38c25babaf67a94586e2255ec09aa76ea2b4,org.apache.tika.utils,277,133,1127,144
32fda63e7bfb1722a3e35d717f68e3242a259c47,org.apache.tika.utils,4,8,1123,-4
f8183f2dffaac516ea48fc3522c302fa4937b26c,org.apache.tika.utils,35,35,1123,0
83cb301f046cf5621e6e71bcd907fef52c491078,org.apache.tika.utils,2,229,896,-227
522f4f3ac2aa2f25be83242fcd5f778d8105615f,org.apache.tika.utils,14,42,868,-28
cfe3527af83d582d12a43a6f42ff30bd2d15a379,org.apache.tika.utils,4,7,865,-3
c30bbcb8a5dfe9367777c00cf4b18d83020faefe,org.apache.tika.utils,47,114,798,-67
7bdb1c8dea70014b3528736755868c526dfcf834,org.apache.tika.utils,284,229,853,55
a03498cc893044e1f4c01adbbfee13881b02f2db,org.apache.tika.utils,122,51,924,71
53d14c5d024a7d25a860123cf38c63fdbeeb16bf,org.apache.tika.utils,18,14,928,4
9a00212a62c01e658f7c780958582f970ae0a886,org.apache.tika.utils,213,154,987,59
d4bb41f7968cb40d39f66b2c0430dde3eef2e618,org.apache.tika.utils,532,532,987,0
ee2c3b90b736e3ccaeaf204a658e917b87d378df,org.apache.tika.utils,2,5,984,-3
6d37de9d208f1f7918df6f81a14a1d3b48a4d37f,org.apache.tika.utils,286,317,953,-31
d840df12cc825d49528d9492a4f49c8093e086bb,org.apache.tika.utils,258,258,953,0
62e58ea2e8ccd2ef1a968349408c990914efa6b6,org.apache.tika.utils,66,95,924,-29
aceff84889da091010bcd893809427428a8b68a6,org.apache.tika.utils,0,160,764,-160
810b1d4d780ad045c2a40a5b51d3dc9aadc9fcca,org.apache.tika.utils,172,20,916,152
54aa413c1fc4b02b1bcd90228e10bb2e91b30876,org.apache.tika.utils,6,5,917,1
838fe5fc64d02bbab15e71131aca84a233558755,org.apache.tika.utils,6,2,921,4
e7d7a1c6227023f0d1b92f9c1eae15e0909b9ba2,org.apache.tika.utils,3,3,921,0
423f67e7e8671d01707e3188c6aeb694db224418,org.apache.tika.utils,22,18,925,4
c943f692982b70a43b4ddec37bc40e2a3de2d318,org.apache.tika.utils,26,26,925,0
a328f9c6ad676d51c34c7dd8584bac72438f99dd,org.apache.tika.utils,49,0,974,49
580824e1088af50d5556e2a01d71311a42a74edc,org.apache.tika.utils,2,6,970,-4
4c8f0b8fff933890990c336e40ff5a419d08321c,org.apache.tika.utils,1,1,970,0
1f2b7168893b8e7e3cb20aaf7992e057d449dd79,org.apache.tika.utils,108,31,1047,77
88d8173fa7b9e5781412c92ec7abdd7a17b17330,org.apache.tika.utils,0,37,1010,-37
64e1e5180b49b78fa4559b3d88503e6d9825483c,org.apache.tika.utils,5,6,1009,-1
3079789724edf724c492c3497630c3cbd5533ef5,org.apache.tika.utils,79,79,1009,0
2a77cf379166e9c2e5144d9cafa37a2146563a36,org.apache.tika.utils,1,1,1009,0
12ec68e67fecb7008f0fa2dab9c1679cdccf6cf5,org.apache.tika.utils,4,28,985,-24
9b7e6ea2b3cde02a42419020859478017fecb51f,org.apache.tika.utils,0,23,962,-23
77abee64d17224f83f32b1ea1e5bce6fc557f72a,org.apache.tika.utils,15,18,959,-3
8189f14efb2e918f5ba941407f05fab9a01ea365,org.apache.tika.utils,0,148,811,-148
1b6a5639611fcea5e81d6891fced6340832b3680,org.apache.tika.utils,0,212,599,-212
8a5cfcb5ac4030ae39d268a17f5cc8dba6c8ab3f,org.apache.tika.utils,3,2,600,1
9ba3b5852ece3f19bcc3925d871a327b3501bbf3,org.apache.tika.utils,160,0,760,160
3dd12110dad0e5a71555d4e4a0e5a6cd609b0fb7,org.apache.tika.utils,20,4,776,16
1bbaa907a3d0fa8f8a21795f00fc46b1e7e7c469,org.apache.tika.utils,23,32,767,-9
5c22595f655362f983e73aca4fb79149f37a17ec,org.apache.tika.utils,49,1,815,48
c4c8b2247dd90e0f5ed3b9eac6da471e013989a8,org.apache.tika.utils,22,0,837,22
de3538527dc7658735a7544c9f904007bc180021,org.apache.tika.utils,0,0,837,0
25f7a4d5dac3b7d4bebaed41ef43bf37d1e86814,org.apache.tika.utils,0,183,654,-183
e910698ed42888d0c30dde88f2ceac7b2f841b98,org.apache.tika.utils,1,1,654,0
929c8972a112ac75e5bec8120f0df5d7e5d5ec60,org.apache.tika.utils,29,15,668,14
12a974733aa3cbeb82194bfcf843e6d831477d9b,org.apache.tika.utils,38,39,667,-1
b8beefd21e5b33dd824baca096080668e7cff27a,org.apache.tika.utils,108,77,698,31
6630079481feb7d70528cc8fad6009b82ee8a9ed,org.apache.tika.utils,0,1,697,-1
dfee81089d1492039ab698528212e1cef4108ea2,org.apache.tika.utils,67,0,764,67
2a36fcd63ddd3234b7f34e6814972bb62aeb4bc9,org.apache.tika.utils,20,4,780,16
15bc1b3a1c5e79c007754760eba5748e99b01fc8,org.apache.tika.utils,34,1,813,33
d943c10d8ee8068523f196f68af2090245815735,org.apache.tika.utils,1,1,813,0
6cc0e11b91ee5ebe97ea91fc50a76074f45829c2,org.apache.tika.utils,2,1,814,1
50dcb7b3e93ad26b006de513dcd51fef4a7d67f4,org.apache.tika.utils,1,1,814,0
7ada2169584970ab9cc8d032c1571dfae78d4fe6,org.apache.tika.utils,90,0,904,90
c3d82a84eb5a5105672b3b237c139c1921020944,org.apache.tika.utils,48,0,952,48
58a757e0f7295af14bb8051a42d75bb0ccc8cfe6,org.apache.tika.utils,59,2,1009,57
3d9454b8d4e387431362d5ca1f59cd88f4fff59b,org.apache.tika.utils,120,0,1129,120
aad23d9e848b8d8e9a5a7a1f4359ef4a2dbdba24,org.apache.tika.utils,321,0,1450,321
49ddf6e39615e8284a7c9e45e76a659725c0ad7a,org.apache.tika.utils,321,0,1771,321
eccc15387f0d4a5c62d8d12e6579878dba2f52a8,org.apache.tika.utils,30,0,1801,30
0305cfb402f5d5e289533411d5737e1e832888ac,org.apache.tika.utils,3,2,1802,1
338db905d4e203d4df4582d5511242eaa922af6b,org.apache.tika.utils,17,7,1812,10
f8fe50a2239cc8875fe3df7de6215e40da48b587,org.apache.tika.utils,6,6,1812,0
027625dd71fe9f5c33a546b7395aee744adb2ae0,org.apache.tika.utils,22,8,1826,14
31cf12d51539c1ec01c12d73f96e7eadfd2339f0,org.apache.tika.utils,2,0,1828,2
9e0a87e68a0a6b45a2f740a58b0db99d9eeecb4a,org.apache.tika.utils,3,1,1830,2
a1d1a81d15b287b44041d590d8b124be06af0a19,org.apache.tika.utils,0,12,1818,-12
afb7e3643a61e9dc6c4921b12bc145b1be4e1402,org.apache.tika.utils,358,0,2176,358
d50a69361bd0196fb2595313cb47222f61701ba4,org.apache.tika.utils,358,0,2534,358
d19e4725ff0549597f9156bb0c1e7759f6ce08d9,org.apache.tika.utils,69,3,2600,66
66f6310eec8e8aade078f0ca32a07399008ef1b1,org.apache.tika.utils,18,16,2602,2
e56e2b2915e8cebcf97c69cdcb3ecff861434f61,org.apache.tika.utils,429,3,3028,426
c0c2eafe46224e5c316f2dede395308930a5ec0d,org.apache.tika.utils,239,0,3267,239
ac259320057d8b7a8937dc5ee183b3a5c346a3bc,org.apache.tika.utils,25,0,3292,25
0e38f9419121f08117283e1876e8abd02b2ab52f,org.apache.tika.utils,17,29,3280,-12
c54efd8b2f319c9c1547b293a5dd2fe80be564fa,org.apache.tika.utils,3,0,3283,3
b5f5403fb150f2a290fe1cfa10a6fe572b1dd50a,org.apache.tika.utils,255,0,3538,255
d5a06ba6d17b0846cfc58b2e3c0a3df6abc31b0c,org.apache.tika.utils,43,0,3581,43
d229ab6f666cde8b007f568b13001a2c780ff477,org.apache.tika.utils,14,0,3595,14
f4a926ca94c50a6158891c7746e725cd720a2faa,org.apache.tika.utils,9,0,3604,9
97b97b345b49b7dd510af560598e6d1ab7baf28c,org.apache.tika.utils,21,1,3624,20
d181c3c05a70163597dd40a9e1b140303ec2739f,org.apache.tika.utils,2,1,3625,1
5bd8b281c932d39aac4b6d7babe0732f853ed2ae,org.apache.tika.utils,55,0,3680,55
54477aa3904944ca964e1f70188ac69b9f994042,org.apache.tika.utils,2,2,3680,0
4b38d6228f4ba5ee912735dc692275499bbf45f6,org.apache.tika.utils,113,16,3777,97
64bb30844e0caafff1c9ebac7c8b0c5b512ea81e,org.apache.tika.utils,12,2,3787,10
8110645cc4b181fefd9663b1592213e79a298b0e,org.apache.tika.utils,6,2,3791,4
e24e6afb1c2a37be266839767115ad6adc5f8dcf,org.apache.tika.utils,156,20,3927,136
bcf09e04d7b232a3d5ac56bd858045e63e41205d,org.apache.tika.utils,86,0,4013,86
c844fc3928516f710a1e62ab99c4eb3f8ab27410,org.apache.tika.utils,1,1,4013,0
e7b481dd763ff4f586a94b981281923e4604010a,org.apache.tika.utils,87,1,4099,86
148adec1016acc122fa5e972f75d7029376998d9,org.apache.tika.utils,95,2,4192,93
4e67928412ad56333d400f3728ecdb59d07d9d63,org.apache.tika.utils,38,5,4225,33
734358f9870c87dd1739f4e995d0d71765965542,org.apache.tika.utils,16,0,4241,16
67981dce07a59ed444306f1a32a47c9b216db101,org.apache.tika.utils,5,6,4240,-1
8fee03ce17b43c72b3c2b7a5dc1b38f1be628dce,org.apache.tika.utils,5,6,4239,-1
82934135598f1ed9ea6f51f21036093fd0463610,org.apache.tika.utils,95,21,4313,74
86d4ba1e1806c8c386e913f6848b938f657df2c6,org.apache.tika.utils,234,47,4500,187
d6dd1b2a169500fc0452d2f7ec2a54ba3d31381a,org.apache.tika.utils,2,1,4501,1
a0688825b15b8d3f1672236b0f1f6536c8a863c4,org.apache.tika.utils,86,9,4578,77
a14e645dc7d754ccdb7bba52dd43df42483368e7,org.apache.tika.utils,0,2,4576,-2
4131c6e30f2e0eb1feb85e0f7576531d4e830468,org.apache.tika.utils,16,0,4592,16
c797a83db923ceb01c9703f4a8a935c231eb9bd7,org.apache.tika.utils,26,24,4594,2
f9cccabcb2d2580739039fbef60f06da97668b13,org.apache.tika.utils,4,4,4594,0
f30f1b8ae195353fccaa681f3440fd7d9743e283,org.apache.tika.utils,13,12,4595,1
6745e8db32390ea94ca14f11ef02aa00f1ffc37e,org.apache.tika.utils,43,40,4598,3
86888d9cdf39455bf8bb8dda05e77e790749476b,org.apache.tika.utils,8,0,4606,8
ce693ed2acf5f70c6e8d919229be96456bf0ce9e,org.apache.tika.utils,6,0,4612,6
22ff7564f2641ba195f192d7c59e9df4a3a10747,org.apache.tika.utils,5,0,4617,5
5215fa69e882a7cf5a543497d8319a31324be790,org.apache.tika.utils,14,4,4627,10
7063b7d1b79495a3c390f06eee1ba451155257ed,org.apache.tika.utils,1,1,4627,0
b329820804bb74cc290337041eee595395e77435,org.apache.tika.utils,5,4,4628,1
cd90587f5d194c1f0e9b5cd5eeb8a995ecb3868f,org.apache.tika.utils,14,0,4642,14
f9104d17ad0b92b243501fdf0863b4ccdaa5e791,org.apache.tika.utils,184,0,4826,184
d4a39b4873d939553e0742487b8c84f072497c1f,org.apache.tika.utils,16,0,4842,16
225d7e572e3bcf980793c60a38e3bfb362f57e31,org.apache.tika.utils,5,1,4846,4
71486d765318062f8cb04cd3335bd9049a2ff5fc,org.apache.tika.utils,47,17,4876,30
793eb4a72916ed3c21413c5faf7662c921f58b49,org.apache.tika.utils,47,17,4906,30
9ec102102119e6d398c53652e1a28c2c61600f5d,org.apache.tika.utils,2,2,4906,0
f23d3777120dd86e1a5e8c1cd43f6f178f1ec956,org.apache.tika.utils,1,1,4906,0
8dbb5736fa92b323e270e2075b42dce458a3abd6,org.apache.tika.utils,0,57,4849,-57
a43784b19f6b0955478dded71521b0491d21c90b,org.apache.tika.utils,57,0,4906,57
8b82b4c942c82f9cc2eb393e669227606b5f15fc,org.apache.tika.utils,67,4,4969,63
813a6eb69853d87ae54fc4bf6183267bb480322d,org.apache.tika.utils,2,2,4969,0
7fd2825613bce5fd741a0126de8d812a316389ba,org.apache.tika.utils,2,2,4969,0
dd85c73094dc87f6f6e208278325be810761f490,org.apache.tika.utils,1,1,4969,0
326b7d7abda238ccc181fc2acaf2271e08fe9c1b,org.apache.tika.utils,1,1,4969,0
7f65d61b4fe1f4c1d4929bbe1c456c68afd44b6c,org.apache.tika.utils,1,1,4969,0
